date,actual_deaths,total_deaths,predicted_deaths_mean,predicted_deaths_lower,predicted_deaths_upper,predicted_total_deaths_mean,predicted_total_deaths_lower,predicted_total_deaths_upper,predicted_new_infected_mean,predicted_new_infected_lower,predicted_new_infected_upper,predicted_current_infected_mean,predicted_current_infected_lower,predicted_current_infected_upper,predicted_total_infected_mean,predicted_total_infected_lower,predicted_total_infected_upper,r_values_mean,r_values_lower,r_values_upper
2020-02-05,0,0,,,,,,,126,66,178,126,66,178,126,66,178,2.26401153092,2.1,2.4
2020-02-06,0,0,,,,,,,126,66,178,252,132,356,252,132,356,2.2640021367,2.0999895174,2.39999969788
2020-02-07,0,0,,,,,,,126,66,178,378,197,534,378,198,534,2.26399896058,2.09998597396,2.39999953722
2020-02-08,0,0,,,,,,,126,66,178,503,264,712,504,264,712,2.26399469817,2.09998123275,2.39999929031
2020-02-09,0,0,,,,,,,287,163,404,790,441,1102,791,427,1116,2.26398897301,2.09997488889,2.39999891128
2020-02-10,0,0,,,,,,,287,163,404,1077,610,1501,1078,590,1520,2.26398127615,2.09996658217,2.39999832968
2020-02-11,0,0,,,,,,,287,163,404,1364,776,1902,1365,753,1924,2.26397091876,2.09995595448,2.39999743698
2020-02-12,0,0,,,,,,,287,163,404,1650,941,2304,1652,916,2328,2.2639569674,2.09994138286,2.39999614599
2020-02-13,0,0,,,,,,,460,277,648,2110,1236,2929,2112,1193,2976,2.26393815563,2.09992148829,2.3999942376
2020-02-14,0,0,,,,,,,670,408,939,2781,1648,3862,2782,1601,3915,2.26388308406,2.09986255273,2.39996710363
2020-02-15,0,0,,,,,,,1208,746,1630,3988,2448,5453,3990,2347,5545,2.26384506032,2.09981948293,2.39995996983
2020-02-16,0,0,,,,,,,2404,1464,3096,6392,4040,8487,6394,3811,8641,2.26378653159,2.09975889955,2.39994322481
2020-02-17,0,0,,,,,,,3885,2516,4924,10277,6688,13322,10279,6327,13565,2.26371158454,2.0996813484,2.39992323095
2020-02-18,0,0,,,,,,,4300,2826,5459,14577,9555,18754,14579,9153,19024,2.26361332521,2.09958046786,2.39989833108
2020-02-19,0,0,,,,,,,5051,3377,6404,19628,12992,25110,19630,12530,25428,2.26348267692,2.09944800873,2.39986467632
2020-02-20,0,0,,,,,,,5192,3479,6599,24693,16417,31521,24822,16009,32027,2.26330649934,2.09927366973,2.39981791226
2020-02-21,0,0,,,,,,,5722,3894,7265,30290,20268,38588,30544,19903,39292,2.26306730268,2.09904124187,2.39975074548
2020-02-22,0,0,,,,,,,6795,4699,8633,36959,24949,47005,37339,24602,47925,2.26274514803,2.09873414419,2.39965583458
2020-02-23,0,0,,,,,,,8140,5717,10322,44973,30693,57075,45479,30319,58247,2.26231129002,2.09832746702,2.39951088149
2020-02-24,0,0,,,,,,,10349,7259,13199,55035,37869,69811,55828,37578,71446,2.26172454369,2.09780916536,2.39932212855
2020-02-25,0,0,,,,,,,16244,10840,20673,70993,48723,89962,72072,48418,92119,2.26092827731,2.09710452032,2.39904645541
2020-02-26,0,0,,,,,,,19626,13322,25043,90332,61925,114564,91698,61740,117162,2.25984448293,2.09621699911,2.39861488176
2020-02-27,0,0,,,,,,,21401,14421,27564,111447,76197,141710,113099,76161,144726,2.25836753656,2.09504392176,2.39801971648
2020-02-28,0,0,,,,,,,25997,17374,33794,136984,93292,174851,139096,93535,178520,2.25635213741,2.09357879156,2.39716581749
2020-02-29,1,1,,,,,,,31813,20685,42020,168127,113578,215891,170909,114220,220540,2.25359785226,2.09159871649,2.39589077506
2020-03-01,0,1,,,,,,,41344,26296,55267,208263,139191,269413,212253,140516,275807,2.24982951658,2.08854034039,2.3940168317
2020-03-02,5,6,,,,,,,51431,32410,69412,257291,170242,335576,263684,172926,345219,2.24467147509,2.0846509529,2.39125795882
2020-03-03,1,7,,,,,,,63835,40051,86825,317240,207871,417330,327519,212977,432044,2.23761494615,2.07935162867,2.38719405942
2020-03-04,4,11,,,,,,,78368,48493,107630,391308,253639,519332,405887,261470,539674,2.22797728804,2.07250983663,2.38121095958
2020-03-05,1,12,,,,,,,98028,60030,135840,484285,310394,648564,503915,321500,675514,2.21485595721,2.06350335274,2.37251065636
2020-03-06,2,14,,,,,,,120169,72851,168147,599262,379874,809866,624084,394351,843661,2.19708479712,2.05123006911,2.35965496868
2020-03-07,3,17,,,,,,,145221,88213,203721,738761,464281,1006142,769305,482564,1047382,2.17320793592,2.02956663115,2.34191869055
2020-03-08,4,21,,,,,,,172617,106224,240824,904582,565797,1238242,941922,588788,1288206,2.141499629,2.00107863723,2.31506300053
2020-03-09,1,22,,,,,,,201600,127419,276294,1098043,687376,1504250,1143522,716207,1564500,2.10007257011,1.94456536026,2.27791197293
2020-03-10,6,28,,,,,,,231091,152392,312280,1318785,832257,1803474,1374613,868599,1876780,2.04712309424,1.86899768363,2.24851730261
2020-03-11,5,33,,,,,,,257335,173963,344479,1559875,995339,2127241,1631948,1042562,2221259,1.98133598385,1.78399426785,2.2155508617
2020-03-12,10,43,,,,,,,278767,189647,371443,1819016,1171533,2473662,1910715,1232209,2592702,1.90239243162,1.69018129307,2.17142649666
2020-03-13,8,51,,,,,,,295217,204175,391298,2092832,1361177,2837366,2205932,1436384,2984000,1.81141153812,1.57146483647,2.11056537827
2020-03-14,7,58,,,,,,,306503,211535,402629,2373337,1555265,3206125,2512435,1647919,3386629,1.71109944598,1.45958091577,2.045418382
2020-03-15,12,70,,,,,,,313978,218552,412956,2655501,1753209,3576900,2826413,1866471,3799585,1.60547505937,1.33753456133,1.97752061917
2020-03-16,27,97,,,,,,,318106,223908,423476,2932264,1951056,3944880,3144519,2090379,4223061,1.49924373245,1.21966965594,1.89181711223
2020-03-17,35,132,,,,,,,319784,227866,427872,3200617,2146902,4303096,3464303,2318245,4650933,1.39704082575,1.12522519159,1.78527986503
2020-03-18,59,191,,,,,,,319869,231546,428236,3456651,2339016,4644188,3784172,2549791,5079169,1.30277548453,1.05243043752,1.66692561412
2020-03-19,73,264,,,,,,,318879,234298,425775,3697162,2525693,4961833,4103051,2784089,5504944,1.21921102024,1.00193603638,1.54506622436
2020-03-20,99,363,,,,,,,317279,236334,423599,3916413,2703151,5248891,4420330,3020423,5928543,1.14781028205,0.965656578381,1.44326465555
2020-03-21,99,462,,,,,,,315174,237562,420845,4111419,2869237,5500849,4735504,3257985,6349388,1.08881059244,0.939487465111,1.3422025627
2020-03-22,110,572,,,,,,,312653,238698,416573,4278851,3021222,5712979,5048157,3496683,6765961,1.04146923453,0.922641287121,1.25802277953
2020-03-23,189,761,,,,,,,309843,238790,410844,4416078,3155418,5882306,5358000,3735473,7176805,1.00440451169,0.902177487863,1.18480582695
2020-03-24,239,1000,,,,,,,306780,238346,403501,4521258,3267901,6008665,5664780,3973819,7580306,0.975943675742,0.8828577453,1.12376351395
2020-03-25,324,1324,,,,,,,303492,235408,396105,4593659,3352111,6091484,5968272,4209227,7976411,0.954401529047,0.869437399071,1.07127991833
2020-03-26,408,1732,,,,,,,299969,234216,389768,4636294,3413452,6135896,6268241,4443443,8366179,0.93825524292,0.860384476622,1.03201782522
2020-03-27,518,2250,,,,,,,296191,231961,382892,4653718,3456378,6146494,6564432,4675404,8749071,0.926223474559,0.85385619344,1.00351569027
2020-03-28,633,2883,,,,,,,292162,228382,375590,4650663,3480607,6129957,6856594,4903786,9124661,0.917279091507,0.849250071681,0.983506471875
2020-03-29,586,3469,,,,,,,287916,224541,368384,4632077,3492907,6094946,7144510,5128327,9493045,0.910625693369,0.84571549136,0.970610125491
2020-03-30,692,4161,,,,,,,283403,220267,361088,4601502,3493460,6042654,7427913,5348594,9854133,0.905659746782,0.843303343419,0.962005964662
2020-03-31,1085,5246,,,,,,,278673,215969,354116,4562068,3483931,5973400,7706586,5564563,10208249,0.901930978448,0.841685179738,0.95670228281
2020-04-01,1172,6418,,,,,,,273742,211669,346809,4516027,3466010,5892949,7980328,5776232,10555058,0.899106991785,0.840391499629,0.952445895183
2020-04-02,1503,7921,,,,,,,268638,207099,339750,4464797,3439928,5805380,8248966,5983331,10894808,0.896944119813,0.839544071835,0.949006751509
2020-04-03,1392,9313,,,,,,,263390,202934,333087,4409307,3407072,5713697,8512356,6186265,11227895,0.895264533176,0.838402252293,0.946492661122
2020-04-04,1523,10836,,,,,,,258023,198391,326548,4350051,3367853,5617713,8770379,6384656,11554443,0.893938791231,0.837535204765,0.944448142357
2020-04-05,1590,12426,,,,,,,252575,193860,319779,4287452,3323179,5517861,9022954,6578516,11874222,0.892872797926,0.836876351014,0.942836267761
2020-04-06,1770,14196,,,,,,,247081,189314,313305,4221881,3273145,5415899,9270035,6767830,12187527,0.891998174126,0.836410886203,0.941638930298
2020-04-07,2571,16767,,,,,,,241576,184776,306397,4153614,3218743,5312693,9511611,6952606,12493924,0.891265210466,0.835767850325,0.940898168956
2020-04-08,2146,18913,,,,,,,236095,180405,299584,4082929,3160538,5209733,9747706,7133011,12793508,0.890637736481,0.835216642733,0.940186611716
2020-04-09,2228,21141,,,,,,,230666,176281,293036,4010102,3101177,5107397,9978372,7309292,13086544,0.890089397195,0.834764768441,0.939604537202
2020-04-10,2218,23359,,,,,,,225313,172180,286559,3935447,3038993,5004798,10203685,7481472,13373103,0.88960095615,0.834297469077,0.939112514739
2020-04-11,2119,25478,,,,,,,220055,167973,279911,3859311,2974880,4902259,10423740,7649445,13653014,0.889155788096,0.834002564103,0.938671731611
2020-04-12,1816,27294,,,,,,,214906,163828,273427,3782055,2910227,4800364,10638646,7813273,13926441,0.888746910656,0.833543701535,0.938299330926
2020-04-13,1946,29240,,,,,,,209874,159846,267242,3704012,2845465,4699381,10848520,7973119,14193683,0.888365735625,0.833234330386,0.937892622521
2020-04-14,2455,31695,,,,,,,204964,155923,261285,3625573,2781092,4599666,11053484,8129042,14454968,0.888007447649,0.832904124136,0.937511225502
2020-04-15,2609,34304,,,,,,,200178,152164,255717,3547078,2717286,4501305,11253662,8281206,14710685,0.887676407855,0.832572069547,0.937156253403
2020-04-16,2176,36480,,,,,,,195516,148431,250212,3468852,2654074,4404722,11449178,8429637,14960897,0.88735969432,0.832298102955,0.936843280699
2020-04-17,2093,38573,,,,,,,190976,144580,244841,3391189,2591600,4309822,11640154,8574217,15205738,0.887058947573,0.832058614128,0.936525062302
2020-04-18,1960,40533,,,,,,,186555,140952,239684,3314354,2529677,4216421,11826709,8715169,15445422,0.88677262388,0.831734284128,0.936204181752
2020-04-19,1931,42464,,,,,,,182250,137334,234776,3238581,2468662,4124666,12008959,8852503,15680198,0.886501590498,0.831403876486,0.93591617116
2020-04-20,2186,44650,,,,,,,178057,133853,230093,3164063,2408681,4035009,12187016,8986356,15910291,0.886245840341,0.83114239539,0.935659985134
2020-04-21,2548,47198,,,,,,,173973,130450,225499,3090955,2349820,3947255,12360989,9116806,16135790,0.886005342406,0.830947109786,0.935410360823
2020-04-22,2434,49632,,,,,,,169996,126950,221211,3019375,2291976,3862147,12530985,9243756,16357001,0.885781545987,0.830770108705,0.935143695005
2020-04-23,2466,52098,,,,,,,166121,123657,216873,2949401,2235197,3779536,12697106,9367413,16573874,0.885577956225,0.830592490059,0.934955088761
2020-04-24,2154,54252,,,,,,,162349,120419,212628,2881083,2179288,3699239,12859455,9487832,16786502,0.885398784917,0.830422330533,0.934754302519
2020-04-25,1698,55950,,,,,,,158676,117260,208499,2814446,2124309,3621295,13018131,9605092,16995001,0.885249936822,0.830245548166,0.934582702707
2020-04-26,1329,57279,,,,,,,155103,114088,204554,2749493,2070364,3546037,13173234,9719180,17199555,0.885139950984,0.830106867093,0.93436404998
2020-04-27,1466,58745,,,,,,,151625,111075,200662,2686213,2017561,3473361,13324859,9830255,17400217,0.885079722575,0.830050517116,0.934142118485
2020-04-28,2241,60986,,,,,,,148243,107947,196881,2624581,1965621,3403076,13473102,9938202,17597098,0.885084217519,0.830003972374,0.933996047075
2020-04-29,2521,63507,,,,,,,144957,104975,193249,2564574,1914637,3335099,13618059,10043177,17790347,0.885173465478,0.829945816288,0.933801795685
2020-04-30,2322,65829,,,,,,,141767,102163,189756,2506164,1864605,3269184,13759826,10145340,17980103,0.885373906789,0.829923188233,0.933736580753
2020-05-01,1891,67720,,,,,,,138674,99418,186493,2449321,1815566,3205498,13898500,10244758,18166596,0.885720189484,0.829972716318,0.933730827988
2020-05-02,1692,69412,,,,,,,135676,96824,183327,2394022,1767785,3144003,14034176,10341582,18349923,0.88625711919,0.830019775493,0.93379573662
2020-05-03,1120,70532,,,,,,,132777,94232,180109,2340244,1721039,3084436,14166953,10435814,18530032,0.887041488459,0.830266732175,0.934284924327
2020-05-04,1333,71865,,,,,,,129979,91747,177015,2287973,1675430,3026672,14296932,10527561,18707047,0.888143431513,0.830426681684,0.934589581826
2020-05-05,2318,74183,,,,,,,127285,89354,174089,2237200,1630911,2970657,14424217,10616915,18881136,0.889646382192,0.830637643856,0.935837828568
2020-05-06,2364,76547,,,,,,,124698,87024,171270,2187925,1587463,2916412,14548915,10703939,19052406,0.891644499004,0.831058106811,0.940264947601
2020-05-07,1934,78481,,,,,,,122223,84818,168576,2140153,1545313,2863758,14671138,10788757,19220982,0.894236295096,0.831218678693,0.953854010201
2020-05-08,1747,80228,,,,,,,119867,82732,166056,2093898,1504372,2812921,14791005,10871489,19387038,0.897513979199,0.831834316048,0.969668698913
2020-05-09,1488,81716,,,,,,,117635,80698,163669,2049184,1464636,2763941,14908640,10952187,19550707,0.901550211324,0.832178216277,0.991280688687
2020-05-10,893,82609,,,,,,,115539,78807,161487,2006047,1426170,2716913,15024179,11030994,19712194,0.906387306645,0.832730624485,1.01670083547
2020-05-11,1014,83623,,,,,,,113588,77052,159385,1964532,1389122,2671728,15137767,11108046,19871579,0.912035855247,0.833506225782,1.04874876002
2020-05-12,1627,85250,,,,,,,111794,75436,157512,1924701,1353473,2628567,15249561,11183482,20029091,0.918486296684,0.834158692102,1.07569335448
2020-05-13,1764,87014,,,,,,,110172,74002,155872,1886630,1319521,2587545,15359733,11257484,20184963,0.925727947009,0.835792231534,1.10236832064
2020-05-14,1783,88797,,,,,,,108736,72670,154305,1850409,1287213,2548590,15468469,11330154,20339268,0.933763091538,0.836762309406,1.12589643227
2020-05-15,1681,90478,,,,,,,107501,71524,153013,1816143,1256576,2511836,15575970,11401678,20492281,0.942607902421,0.838496215472,1.1470973559
2020-05-16,1216,91694,,,,,,,106483,70501,152079,1783953,1227665,2477409,15682453,11472179,20644360,0.952283783212,0.841972595947,1.16526378024
2020-05-17,758,92452,,,,,,,105696,69634,151257,1753972,1200484,2445327,15788149,11541813,20795617,0.962807916326,0.846523168433,1.17887808163
2020-05-18,1172,93624,,,,,,,105154,68981,150837,1726350,1175249,2416042,15893303,11610794,20946454,0.974183618686,0.85239317912,1.19450506295
2020-05-19,1552,95176,,,,,,,104871,68492,150875,1701242,1152011,2389879,15998174,11679286,21097329,0.986381517723,0.85989646202,1.22668132483
2020-05-20,1526,96702,,,,,,,104861,68303,151194,1678818,1130986,2366957,16103035,11747589,21248523,0.999308701781,0.869384455112,1.23775620353
2020-05-21,1217,97919,,,,,,,105135,68298,151701,1659255,1112291,2347356,16208170,11815887,21400224,1.0127820562,0.875067689643,1.25287600685
2020-05-22,1244,99163,,,,,,,105704,68468,152631,1642735,1095976,2331372,16313874,11884355,21552855,1.02653195974,0.875706547931,1.25715259816
2020-05-23,1109,100272,,,,,,,106579,68952,154024,1629448,1082237,2319297,16420453,11953307,21706879,1.04024768384,0.875807690177,1.26547305134
2020-05-24,622,100894,,,,,,,107772,69684,155844,1619585,1071272,2311424,16528225,12022991,21862723,1.05364667294,0.876032278463,1.27699465784
2020-05-25,548,101442,,,,,,,109293,70587,157905,1613339,1063106,2307791,16637518,12093578,22020628,1.06653200905,0.876823056739,1.2857974265
2020-05-26,662,102104,,,,,,,111159,71814,160048,1610910,1057927,2308411,16748677,12165392,22180676,1.07881036306,0.877783680946,1.29747555953
2020-05-27,1518,103622,,,,,,,113383,73407,162807,1612499,1055950,2313654,16862060,12238799,22343483,1.09046945923,0.87914510125,1.30934512889
2020-05-28,1178,104800,,,,,,,115969,75287,166134,1618296,1057287,2323856,16978029,12314086,22509617,1.10153648942,0.88158960372,1.31373189339
2020-05-29,1160,105960,,,,,,,118930,77465,169819,1628490,1062133,2339313,17096959,12391551,22679436,1.11204269609,0.883809804338,1.32303021436
2020-05-30,963,106923,,,,,,,122281,79972,174109,1643270,1070621,2360341,17219240,12471523,22853545,1.12204631278,0.887120343025,1.33522440324
2020-05-31,581,107504,,,,,,,126039,82757,179188,1662826,1082912,2387373,17345279,12554280,23032733,1.1315945878,0.891658719725,1.34411264803
2020-06-01,776,108280,,,,,,,130224,85830,184517,1687354,1099141,2420561,17475503,12640110,23217250,1.14074258445,0.898671446279,1.34915293901
2020-06-02,1068,109348,,,,,,,134852,89232,190627,1717052,1119422,2460285,17610355,12729342,23407877,1.1494980909,0.908352836285,1.35140911994
2020-06-03,1007,110355,,,,,,,139943,93130,197462,1752124,1144081,2506794,17750298,12822472,23605339,1.15783695972,0.921067965046,1.35320550861
2020-06-04,1023,111378,,,,,,,145517,97297,204781,1792780,1173084,2560284,17895815,12919769,23810120,1.16568460118,0.930095864268,1.35542926289
2020-06-05,914,112292,,,,,,,151593,101931,212566,1839238,1206722,2621059,18047408,13021700,24022686,1.17297356344,0.934759776477,1.35572725011
2020-06-06,659,112951,,,,,,,158192,106863,220885,1891727,1245118,2689231,18205600,13128563,24243571,1.1796513784,0.940786719448,1.35574014255
2020-06-07,438,113389,,,,,,,165334,112282,229853,1950481,1288448,2765000,18370934,13240845,24473424,1.18564894271,0.947315027637,1.35531161172
2020-06-08,519,113908,,,,,,,173036,118292,240505,2015744,1337060,2849605,18543970,13359137,24713929,1.19093377009,0.95687620092,1.3542953798
2020-06-09,950,114858,,,,,,,181312,124640,251312,2087764,1391122,2942970,18725282,13483777,24965241,1.19543938249,0.968269994665,1.35400042589
2020-06-10,901,115759,,,,,,,190172,131410,262779,2166776,1450728,3045681,18915454,13615187,25228020,1.1991321788,0.984319620627,1.35409939622
2020-06-11,871,116630,,,,,,,199617,138374,275584,2253011,1515703,3158439,19115071,13753561,25503604,1.20199021757,1.00760150645,1.35419396965
2020-06-12,828,117458,,,,,,,209644,146100,289492,2346686,1586520,3281777,19324715,13899661,25793096,1.20397918756,1.03482121055,1.35271262682
2020-06-13,759,118217,,,,,,,220236,153746,303610,2447992,1662805,3415545,19544951,14053407,26096706,1.20508500572,1.05529045714,1.3530956326
2020-06-14,308,118525,,,,,,,231363,161903,318257,2557074,1744730,3559682,19776314,14215310,26414963,1.20525835114,1.04936964756,1.35382688606
2020-06-15,394,118919,,,,,,,242981,170424,333210,2674015,1832382,3713710,20019295,14385734,26748173,1.20449168036,1.04806296723,1.35307081367
2020-06-16,838,119757,,,,,,,255025,179810,349395,2798816,1926339,3878613,20274320,14565544,27097568,1.20274639909,1.03738920638,1.35241215893
2020-06-17,744,120501,,,,,,,267419,189124,364981,2931383,2026196,4052992,20541739,14754668,27462549,1.20002154067,1.03015988816,1.35100368608
2020-06-18,718,121219,,,,,,,280068,199008,380534,3071508,2132050,4236111,20821807,14953676,27843083,1.19632364738,1.02427526391,1.35035777972
2020-06-19,670,121889,,,,,,,292864,208868,396398,3218856,2243595,4427762,21114671,15162544,28239481,1.1916513314,1.00984559048,1.35035531362
2020-06-20,604,122493,,,,,,,305687,219221,411255,3372950,2360862,4626474,21420358,15381765,28650736,1.18602201153,1.00399394678,1.35260623923
2020-06-21,285,122778,,,,,,,318407,229925,426484,3533165,2483901,4832085,21738765,15611690,29077220,1.17945853291,0.994246730504,1.35293529026
2020-06-22,389,123167,,,,,,,330888,240475,441036,3698719,2612067,5043257,22069653,15852165,29518256,1.17206283622,0.98666653968,1.35314310493
2020-06-23,847,124014,,,,,,,342995,250710,455210,3868678,2744437,5257933,22412648,16102875,29973466,1.16396844795,0.982488329701,1.35284296805
2020-06-24,759,124773,,,,,,,354600,260720,469250,4041967,2880457,5475797,22767248,16363595,30442716,1.15533734049,0.976511740117,1.35153884813
2020-06-25,551,125324,,,,,,,365594,269978,481695,4217389,3018961,5694619,23132842,16633573,30924411,1.14634238438,0.96982519233,1.35036628247
2020-06-26,617,125941,,,,,,,375888,278685,493383,4393661,3159221,5912316,23508730,16912258,31417794,1.13711976533,0.961296588063,1.35095432265
2020-06-27,504,126445,,,,,,,385418,287287,503023,4569435,3300373,6125727,23894148,17199545,31920817,1.12781274988,0.953967605606,1.35088216599
2020-06-28,273,126718,,,,,,,394143,295767,512033,4743342,3442381,6334072,24288291,17495312,32432850,1.11852592542,0.946367305505,1.35030482807
2020-06-29,377,127095,,,,,,,402040,302691,520256,4914019,3583188,6536034,24690331,17798003,32953106,1.1093513099,0.941123435316,1.34802554044
2020-06-30,625,127720,,,,,,,409101,309101,527454,5080140,3721929,6730337,25099432,18107104,33480560,1.10034933782,0.938469453299,1.34605118606
2020-07-01,694,128414,,,,,,,415329,314324,534431,5240443,3856503,6915473,25514761,18421428,34014991,1.09153487243,0.934529913459,1.34264089499
2020-07-02,727,129141,,,,,,,420737,319292,540987,5393761,3986748,7091624,25935498,18740720,34555978,1.08290461691,0.931405018494,1.33789887361
2020-07-03,660,129801,,,,,,,425353,323857,546290,5539046,4111684,7257522,26360851,19064577,35102268,1.07442611029,0.929268239846,1.3312447347
2020-07-04,265,130066,,,,,,,429210,327224,549723,5675392,4230108,7410997,26790061,19391801,35651991,1.06607880948,0.92413563454,1.32218516003
2020-07-05,288,130354,,,,,,,432349,330058,554130,5802054,4340988,7553985,27222410,19721859,36206121,1.05785808336,0.917551387445,1.31044425043
2020-07-06,355,130709,,,,,,,434809,332859,556738,5918455,4443950,7684286,27657219,20054718,36762859,1.04978100463,0.914218830272,1.30041027367
2020-07-07,1222,131931,,,,,,,436631,334452,558419,6024198,4537930,7801652,28093850,20389170,37321278,1.04188082667,0.910144373285,1.28990208021
2020-07-08,863,132794,,,,,,,437851,335622,559454,6119055,4622822,7905855,28531701,20724792,37880732,1.0342023465,0.907620453306,1.28068575186
2020-07-09,1003,133797,,,,,,,438505,336844,559650,6202960,4698926,7996197,28970206,21061636,38440382,1.02679509165,0.905486405477,1.27278451126
2020-07-10,824,134621,,,,,,,438625,337460,559435,6275990,4766387,8073865,29408831,21399096,38999817,1.01970780967,0.902744974432,1.26284687754
2020-07-11,690,135311,,,,,,,438242,337577,558699,6338344,4825259,8139138,29847073,21736673,39558516,1.01298950781,0.901292804402,1.25186430765
2020-07-12,459,135770,,,,,,,437389,337400,557744,6390314,4875362,8193849,30284462,22074073,40116260,1.00668372387,0.898998243682,1.23638250137
2020-07-13,367,136137,,,,,,,436095,337607,555399,6432266,4917211,8237186,30720557,22411680,40671659,1.00081932188,0.896680396181,1.22407789705
2020-07-14,926,137063,,,,,,,434390,337044,553396,6464615,4951587,8270320,31154947,22748724,41225055,0.995404810231,0.895996333497,1.20676193938
2020-07-15,968,138031,,,,,,,432300,335721,550957,6487814,4978252,8293812,31587247,23084445,41776012,0.990431346527,0.895061104463,1.18685466388
2020-07-16,943,138974,,,,,,,429854,334043,547776,6502339,4998004,8307172,32017101,23418488,42323788,0.985881728226,0.892752273246,1.17802904836
2020-07-17,930,139904,,,,,,,427076,331091,544421,6508678,5009806,8310645,32444177,23749579,42868209,0.981737944446,0.891341453163,1.15899086386
2020-07-18,868,140772,,,,,,,423992,328494,540152,6507316,5014449,8304567,32868169,24078073,43408361,0.977982925018,0.890850518604,1.14107476041
2020-07-19,447,141219,,,,,,,420626,325287,535763,6498732,5012508,8290656,33288795,24403360,43944124,0.974598216808,0.890378538791,1.12912170809
2020-07-20,514,141733,,,,,,,417005,321859,530950,6483388,5004277,8267532,33705800,24725219,44475074,0.971561687003,0.886256944744,1.10816915215
2020-07-21,1107,142840,,,,,,,413150,318813,526792,6461729,4990197,8237641,34118950,25044032,45001866,0.968847233985,0.881151453963,1.0906776149
2020-07-22,1216,144056,,,,,,,409087,315308,521830,6434185,4971008,8201097,34528037,25359340,45523696,0.966425893472,0.878493965053,1.07026980002
2020-07-23,1094,145150,,,,,,,404836,311380,517141,6401171,4946709,8158833,34932873,25670720,46040837,0.96426722502,0.877109654461,1.0565938373
2020-07-24,1132,146282,,,,,,,400421,307404,512528,6363086,4917207,8111758,35333294,25978124,46553365,0.962340609955,0.876340427754,1.05074382184
2020-07-25,899,147181,,,,,,,395903,303705,507524,6320365,4883389,8059901,35729197,26281829,47060889,0.960616550606,0.875715615529,1.04372123361
2020-07-26,472,147653,,,,,,,391258,299257,501994,6273381,4845003,8003254,36120455,26581086,47562883,0.959067944108,0.875134744205,1.04011988177
2020-07-27,1120,148773,,,,,,,386506,295189,497164,6222498,4802721,7942757,36506961,26876275,48060047,0.957671079503,0.874397291352,1.03746795037
2020-07-28,1374,150147,,,,,,,381667,291011,491947,6168070,4756066,7879392,36888628,27167286,48551994,0.956406082631,0.873543769838,1.03375997517
2020-07-29,1432,151579,,,,,,,376760,286705,487034,6110440,4705673,7813135,37265388,27453991,49039028,0.955256701566,0.873020191824,1.0293754614
2020-07-30,1209,152788,,,,,,,371805,282519,481969,6049945,4652426,7744246,37637193,27736510,49520997,0.954209563281,0.872597325249,1.02823409574
2020-07-31,1243,154031,,,,,,,366812,277636,475907,5986903,4595983,7672468,38004005,28014146,49996904,0.953253210855,0.872196921777,1.02642022241
2020-08-01,1115,155146,,,,,,,361789,272815,469952,5921617,4537667,7598072,38365794,28286961,50466856,0.952377258551,0.871815712631,1.02571759829
2020-08-02,403,155549,,,,,,,356749,268232,464300,5854375,4477376,7522278,38722543,28555193,50931156,0.951571878453,0.871451160607,1.02507370433
2020-08-03,530,156079,,,,,,,351702,263462,458455,5785450,4415528,7445026,39074245,28818655,51389611,0.950827647753,0.871101286657,1.02369409778
2020-08-04,1378,157457,,,,,,,346656,258615,452830,5715101,4352259,7366956,39420901,29077270,51842441,0.950135647991,0.870764537454,1.0231956571
2020-08-05,1376,158833,,,,,,,341620,253904,447594,5643571,4287325,7287785,39762521,29331174,52290035,0.949487664824,0.870439684404,1.02256647428
2020-08-06,1253,160086,,,,,,,336602,249316,442348,5571086,4221312,7208323,40099123,29580490,52732383,0.94887636893,0.87012574671,1.02210330643
2020-08-07,1242,161328,,,,,,,331607,244791,436859,5497857,4154709,7128053,40430730,29825281,53169242,0.948295417966,0.869821932814,1.02163898372
2020-08-08,1077,162405,,,,,,,326640,239860,431447,5424076,4087155,7046979,40757370,30065141,53600689,0.947739469724,0.869527595848,1.02117329013
2020-08-09,511,162916,,,,,,,321992,235353,426380,5350165,4018798,6965835,41079362,30300494,54027069,0.947204124706,0.86924219976,1.0204582752
2020-08-10,527,163443,,,,,,,317372,230947,421610,5276280,3950488,6885456,41396734,30531441,54448679,0.946685825147,0.868964262917,1.01988398034
2020-08-11,1064,164507,,,,,,,312797,226438,416988,5202571,3881741,6805288,41709531,30757879,54865667,0.946181734916,0.868696470014,1.01927599101
2020-08-12,1505,166012,,,,,,,308284,222103,412640,5129188,3812831,6725988,42017815,30979982,55278307,0.94568961795,0.868410174354,1.01863821987
2020-08-13,1070,167082,,,,,,,303860,218142,407864,5056288,3744267,6646816,42321675,31198124,55686171,0.945207725784,0.868126384163,1.01807779359
2020-08-14,1338,168420,,,,,,,299555,214029,403515,4984038,3675779,6568375,42621230,31412153,56089686,0.944734699332,0.867850471604,1.0175157979
2020-08-15,1034,169454,,,,,,,295347,209924,398960,4912574,3608068,6491432,42916577,31622077,56488646,0.944269486374,0.867582219429,1.01688140352
2020-08-16,571,170025,,,,,,,291221,205674,395113,4842005,3540929,6416596,43207798,31827751,56883759,0.943811274118,0.867321419554,1.0161827039
2020-08-17,446,170471,,,,,,,287175,201763,391068,4772430,3474457,6343362,43494973,32029514,57274827,0.943359435176,0.867067871749,1.01548139596
2020-08-18,1325,171796,,,,,,,283210,197988,387279,4703939,3408981,6272184,43778183,32227502,57662106,0.942913484894,0.866817466906,1.01477756259
2020-08-19,1353,173149,,,,,,,279336,194433,383847,4636619,3344793,6203202,44057519,32421935,58045953,0.94247304803,0.866571590641,1.014071289
2020-08-20,1079,174228,,,,,,,275551,190709,380021,4570549,3281594,6135631,44333070,32612644,58425974,0.942037832923,0.866305458452,1.01336266249
2020-08-21,1105,175333,,,,,,,271849,187080,376203,4505797,3219353,6069494,44604919,32799724,58802177,0.9416076116,0.865957357834,1.01269517351
2020-08-22,982,176315,,,,,,,268229,183628,372959,4442419,3158187,6005609,44873148,32983352,59175136,0.941182204512,0.865620483512,1.01209562227
2020-08-23,450,176765,,,,,,,264687,180127,369856,4380466,3098451,5944032,45137835,33163479,59544992,0.940761468877,0.865294186672,1.01161140751
2020-08-24,442,177207,,,,,,,261373,176826,366987,4319846,3039921,5884651,45399208,33340305,59911979,0.941304155007,0.866787955559,1.01169304304
2020-08-25,1239,178446,,,,,,,258135,173569,363901,4260609,2982542,5826955,45657343,33513874,60275880,0.941854180674,0.867848619628,1.01215829931
2020-08-26,1225,179671,,,,,,,254980,170526,361213,4202792,2926630,5771186,45912323,33684400,60637093,0.942411070293,0.867957197247,1.01345405767
2020-08-27,1111,180782,,,,,,,251913,167551,358287,4146421,2872078,5716832,46164236,33851951,60995380,0.942974776947,0.869679600056,1.01396991929
2020-08-28,971,181753,,,,,,,248947,164568,355415,4091509,2818505,5664369,46413183,34016519,61350795,0.943545242831,0.870015491602,1.01618371698
2020-08-29,958,182711,,,,,,,246096,161640,352988,4038050,2766117,5613819,46659279,34178159,61703783,0.944122396478,0.87003617581,1.01744133923
2020-08-30,310,183021,,,,,,,243347,158625,350980,3986050,2714820,5565809,46902626,34336784,62054763,0.944706129341,0.870385653774,1.01977667293
2020-08-31,573,183594,,,,,,,240692,155949,349035,3935520,2665097,5519701,47143318,34492733,62403798,0.945296291785,0.86998805205,1.02121551324
2020-09-01,1067,184661,,,,,,,238128,153312,346993,3886473,2616648,5475593,47381446,34646045,62750791,0.945892769262,0.871202549143,1.02289698483
2020-09-02,1056,185717,,,,,,,235655,150696,345614,3838918,2569358,5433896,47617101,34796741,63096405,0.946495473902,0.871597452878,1.02506265101
2020-09-03,1070,186787,,,,,,,233279,148143,344850,3792861,2523067,5394866,47850380,34944884,63441255,0.94710431846,0.871392125893,1.02733132197
2020-09-04,965,187752,,,,,,,230997,145707,343466,3748308,2478063,5358286,48081377,35090591,63784721,0.94771921406,0.870645251421,1.02963264775
2020-09-05,783,188535,,,,,,,228808,143332,342470,3705267,2434313,5324531,48310185,35233923,64127191,0.948340055726,0.870744663424,1.03195213901
2020-09-06,403,188938,,,,,,,226709,141069,341865,3663747,2391753,5293415,48536894,35374992,64469056,0.948966738354,0.870972401434,1.03415252617
2020-09-07,267,189205,,,,,,,224699,138804,341293,3623758,2350429,5264824,48761593,35513796,64810349,0.949599162486,0.870369562795,1.03642795514
2020-09-08,445,189650,,,,,,,222778,136518,340705,3585164,2310120,5238517,48984371,35650314,65151054,0.950237231689,0.871087974007,1.03882930892
2020-09-09,1206,190856,,,,,,,220947,134377,339551,3547976,2270929,5214151,49205318,35784691,65490605,0.950880848968,0.870898356895,1.0410528484
2020-09-10,907,191763,,,,,,,219206,132284,339074,3512201,2232689,5192002,49424524,35916975,65829679,0.95152991272,0.870669091418,1.0432757717
2020-09-11,1213,192976,,,,,,,217552,130365,339012,3477840,2195505,5172718,49642076,36047340,66168691,0.952184317984,0.870206337554,1.04554928758
2020-09-12,714,193690,,,,,,,215987,128465,338870,3444880,2159401,5156168,49858063,36175805,66507561,0.95284395894,0.86937335411,1.04782585827
2020-09-13,378,194068,,,,,,,214510,126467,338950,3413294,2124226,5142131,50072573,36302272,66846511,0.953508729238,0.868509839192,1.05015538241
2020-09-14,422,194490,,,,,,,213120,124752,339459,3383067,2090352,5130612,50285693,36427024,67185970,0.954178521301,0.86680587744,1.05262182603
2020-09-15,1288,195778,,,,,,,211819,122896,339779,3354194,2057299,5121370,50497512,36549920,67525749,0.954853224946,0.865540433346,1.05536657988
2020-09-16,982,196760,,,,,,,210606,121176,340397,3326672,2025162,5114793,50708118,36671096,67866146,0.955532726968,0.864221468671,1.05903301681
2020-09-17,870,197630,,,,,,,209481,119528,341276,3300498,1993994,5110477,50917599,36790624,68207422,0.956216911515,0.8627765594,1.06165861945
2020-09-18,937,198567,,,,,,,208445,117799,342178,3275664,1963649,5107823,51126044,36908423,68549600,0.956905660339,0.861999141578,1.06558213919
2020-09-19,689,199256,,,,,,,207498,116162,343613,3252164,1934104,5107991,51333542,37024585,68893213,0.957598852676,0.861248109214,1.06968347029
2020-09-20,250,199506,,,,,,,206641,114612,345105,3229998,1905382,5110646,51540183,37139197,69238318,0.958296364799,0.860002416115,1.0728139771
2020-09-21,,,691.941225447,468,975,200197.941225,199974,200481,205874,113160,346850,3209163,1877471,5115647,51746057,37252357,69585168,0.958998069621,0.85822309696,1.07593333082
2020-09-22,,,681.483188541,459,965,200879.424414,200434,201445,205199,111690,348936,3189663,1850355,5123301,51951256,37364047,69934104,0.959703836552,0.856373845612,1.07919760051
2020-09-23,,,671.311460656,450,955,201550.735875,200884,202400,204615,110260,351595,3171500,1824097,5134196,52155871,37474307,70285699,0.96041353142,0.854525835422,1.08245707574
2020-09-24,,,661.51428319,441,946,202212.250158,201325,203346,204124,108772,354135,3154677,1798493,5148785,52359995,37583079,70639834,0.961127016341,0.852759627863,1.08571084858
2020-09-25,,,652.069430359,432,937,202864.319588,201757,204282,203727,107439,356935,3139198,1773648,5166647,52563722,37690518,70996769,0.961844149468,0.850911408302,1.08825015008
2020-09-26,,,642.959095303,423,927,203507.278683,202181,205209,203425,106255,359918,3125071,1749537,5187545,52767147,37796773,71356687,0.962564784688,0.849084630841,1.09087220539
2020-09-27,,,634.168869928,414,919,204141.447553,202596,206127,203220,105009,363214,3112304,1726081,5211879,52970367,37901782,71719901,0.963288771363,0.847342531509,1.09347055287
2020-09-28,,,625.686853618,406,912,204767.134407,203003,207038,203112,103771,366601,3100906,1703386,5239527,53173479,38005553,72086502,0.964015954093,0.845527595001,1.09627313208
2020-09-29,,,617.50281133,398,906,205384.637218,203402,207943,203104,102535,370328,3090889,1681170,5270385,53376583,38108088,72456830,0.964746172479,0.843720198014,1.09964258685
2020-09-30,,,609.60794747,391,900,205994.245166,203793,208842,203196,101316,373965,3082267,1659592,5304560,53579779,38209404,72830795,0.96547926085,0.841920232753,1.10254544193
2020-10-01,,,601.994844446,383,895,206596.24001,204177,209736,203392,100213,377893,3075054,1638629,5342041,53783171,38309617,73208688,0.966223210976,0.840127591656,1.10695430967
2020-10-02,,,594.657239332,376,889,207190.89725,204554,210625,203693,99139,382336,3069266,1618241,5383084,53986864,38408756,73591024,0.966973249745,0.838417406294,1.11062027662
2020-10-03,,,587.589837708,369,884,207778.487087,204923,211508,204101,98191,387463,3064921,1598635,5428350,54190965,38506947,73978487,0.967725803472,0.836634698646,1.1138980581
2020-10-04,,,580.789866949,362,880,208359.276954,205286,212388,204618,97184,392982,3062041,1579658,5477703,54395583,38604131,74371469,0.968484298698,0.834869173438,1.11738364542
2020-10-05,,,575.546660263,356,878,208934.823615,205643,213266,205246,96205,399005,3060646,1561250,5531587,54600829,38700336,74770474,0.969248498256,0.833129511993,1.12102461412
2020-10-06,,,570.539440035,351,876,209505.363055,205994,214141,205989,95217,404949,3060760,1543307,5589662,54806818,38795553,75175423,0.970016590183,0.831364808756,1.12463068322
2020-10-07,,,565.767312895,345,874,210071.130367,206340,215014,206848,94311,411950,3062409,1525926,5652657,55013666,38889864,75587373,0.970786151188,0.829749440139,1.12822729679
2020-10-08,,,561.229531307,340,873,210632.359899,206680,215886,207827,93433,419806,3065622,1509097,5720848,55221493,38983297,76007179,0.971557688138,0.82818822555,1.13181317725
2020-10-09,,,556.925681544,335,872,211189.28558,207016,216757,208929,92529,427413,3070426,1492853,5794117,55430422,39075826,76434592,0.972339744363,0.827030748028,1.13544518853
2020-10-10,,,552.855388791,330,871,211742.140969,207347,217627,210156,91705,435764,3076855,1477117,5872943,55640578,39167531,76870356,0.973132053917,0.825667819756,1.13865322172
2020-10-11,,,549.018345883,325,871,212291.159315,207672,218497,211512,90884,444807,3084942,1461745,5957834,55852090,39258415,77315163,0.97392792871,0.825158163317,1.14184027361
2020-10-12,,,545.414349647,320,872,212836.573665,207993,219368,213000,90105,454488,3094723,1446842,6049116,56065090,39348520,77769651,0.974725379953,0.824894709674,1.14488943387
2020-10-13,,,542.043409585,315,873,213378.617074,208309,220239,214625,89366,464433,3106236,1432437,6146964,56279715,39437886,78234084,0.975526220137,0.824007320923,1.14796824
2020-10-14,,,538.905834789,311,873,213917.522909,208620,221111,216391,88719,473586,3119523,1418622,6250232,56496106,39526605,78707670,0.976332779421,0.823122560387,1.15102179964
2020-10-15,,,536.002127499,306,875,214453.525037,208927,221985,218300,88082,483743,3134627,1405390,6360016,56714406,39614687,79191413,0.977160541944,0.822955698395,1.1549809831
2020-10-16,,,533.332975375,303,877,214986.858012,209230,222862,220358,87421,495051,3151593,1392600,6477169,56934764,39702108,79686464,0.977994075265,0.822571817437,1.15961242868
2020-10-17,,,530.899271705,299,880,215517.757284,209529,223740,222567,86923,506252,3170467,1380386,6601077,57157331,39789031,80192716,0.978828592915,0.821935635302,1.16432163503
2020-10-18,,,528.702148926,294,884,216046.459433,209825,224623,224932,86319,518498,3191299,1368518,6732102,57382263,39875350,80711214,0.979663486487,0.821681160774,1.16740276565
2020-10-19,,,526.7445409,291,889,216573.203973,210116,225510,227458,85680,530190,3214139,1357021,6869304,57609721,39961030,81241404,0.980498732669,0.821617868578,1.16954304336
2020-10-20,,,525.028593123,287,893,217098.232567,210404,226402,230147,85116,542472,3239039,1345939,7012763,57839868,40046146,81783876,0.981334727696,0.821620259962,1.17161029963
2020-10-21,,,523.555902387,284,900,217621.788469,210688,227301,233005,84593,556147,3266055,1335321,7163953,58072873,40130739,82340023,0.982173854657,0.820543653024,1.17421773693
2020-10-22,,,522.328410649,280,907,218144.11688,210969,228206,236035,84141,570626,3295242,1325158,7322618,58308908,40214880,82910649,0.983029236692,0.820133749487,1.17621193306
2020-10-23,,,521.348411201,277,913,218665.465291,211246,229117,239241,83793,586332,3326655,1315523,7489129,58548149,40298673,83496981,0.983885248018,0.819361798748,1.18007024959
2020-10-24,,,520.614687929,273,920,219186.079979,211521,230036,242625,83418,601358,3360351,1306415,7663060,58790774,40382091,84098339,0.9847395998,0.819224759764,1.18377240166
2020-10-25,,,520.130675621,270,929,219706.210654,211792,230963,246194,83036,618501,3396389,1297747,7845779,59036968,40465127,84716840,0.985592653909,0.818063362176,1.18743674433
2020-10-26,,,519.900136687,267,938,220226.110791,212060,231899,249952,82722,635648,3434829,1289586,8036603,59286920,40547849,85352488,0.986445476439,0.817436069386,1.19105997945
2020-10-27,,,519.927164778,264,947,220746.037956,212325,232844,253904,82379,653585,3475733,1281861,8235685,59540824,40630228,86006073,0.987292896308,0.816776701206,1.19463859749
2020-10-28,,,520.21620232,261,957,221266.254158,212587,233799,258046,82067,672167,3519153,1274562,8443396,59798870,40712295,86678240,0.988136976206,0.816740224045,1.19808059597
2020-10-29,,,520.772104296,258,967,221787.026262,212846,234763,262387,81846,690848,3565150,1267687,8660627,60061257,40794141,87369088,0.988980000293,0.816706148851,1.20135759932
2020-10-30,,,521.600114717,256,979,222308.626377,213103,235739,266929,81593,710768,3613778,1261196,8887618,60328186,40875734,88079856,0.989821654722,0.816238100171,1.20469038309
2020-10-31,,,522.705854603,253,991,222831.332232,213356,236728,271676,81454,732271,3665096,1255227,9124808,60599862,40957188,88812127,0.990655651897,0.816159076566,1.20649737779
2020-11-01,,,524.095318645,251,1006,223355.42755,213608,237731,276627,81278,752653,3719156,1249580,9371179,60876489,41038466,89564780,0.991478686587,0.816002573287,1.20826987421
