date,actual_deaths,total_deaths,predicted_deaths_mean,predicted_deaths_lower,predicted_deaths_upper,predicted_total_deaths_mean,predicted_total_deaths_lower,predicted_total_deaths_upper,predicted_new_infected_mean,predicted_new_infected_lower,predicted_new_infected_upper,predicted_current_infected_mean,predicted_current_infected_lower,predicted_current_infected_upper,predicted_total_infected_mean,predicted_total_infected_lower,predicted_total_infected_upper,r_values_mean,r_values_lower,r_values_upper
2020-02-05,0,0,,,,,,,125,65,178,125,65,178,125,65,178,2.27077519527,2.1,2.4
2020-02-06,0,0,,,,,,,125,65,178,250,130,356,250,130,356,2.2707656083,2.0999910329,2.39999972908
2020-02-07,0,0,,,,,,,125,65,178,376,194,534,375,195,534,2.27076237114,2.09998812096,2.3999995937
2020-02-08,0,0,,,,,,,125,65,178,501,260,712,500,260,712,2.27075802812,2.09998426342,2.39999937873
2020-02-09,0,0,,,,,,,287,163,404,788,438,1103,787,423,1116,2.27075219634,2.0999791532,2.39999907585
2020-02-10,0,0,,,,,,,287,163,404,1075,606,1502,1074,586,1520,2.2707443583,2.09997238355,2.39999862481
2020-02-11,0,0,,,,,,,287,163,404,1363,772,1904,1361,749,1924,2.2707338137,2.09996341561,2.39999795452
2020-02-12,0,0,,,,,,,287,163,404,1650,937,2306,1648,912,2328,2.27071961376,2.09995153559,2.39999686726
2020-02-13,0,0,,,,,,,468,279,650,2118,1237,2936,2116,1191,2978,2.27070047133,2.09993579797,2.39999521615
2020-02-14,0,0,,,,,,,676,410,937,2794,1653,3867,2792,1601,3915,2.2706445388,2.09988223123,2.39996829139
2020-02-15,0,0,,,,,,,1217,749,1629,4011,2458,5457,4009,2350,5544,2.27060587441,2.0998506345,2.39996182018
2020-02-16,0,0,,,,,,,2411,1472,3099,6423,4059,8495,6420,3822,8643,2.27054635778,2.09980116211,2.3999463959
2020-02-17,0,0,,,,,,,3898,2526,4926,10321,6719,13335,10318,6348,13569,2.27047015571,2.09973989288,2.39992917301
2020-02-18,0,0,,,,,,,4315,2841,5462,14635,9602,18771,14633,9189,19031,2.27037025974,2.09966202083,2.39990627268
2020-02-19,0,0,,,,,,,5074,3404,6413,19709,13070,25141,19707,12593,25444,2.27023744441,2.09956150464,2.39987432656
2020-02-20,0,0,,,,,,,5213,3511,6604,24797,16528,31558,24920,16104,32048,2.27005835037,2.09942946561,2.39982817608
2020-02-21,0,0,,,,,,,5743,3928,7267,30415,20415,38627,30663,20032,39315,2.26981519828,2.09925000591,2.39976698058
2020-02-22,0,0,,,,,,,6831,4748,8649,37121,25143,47060,37494,24780,47964,2.26948773681,2.09900802903,2.39967621786
2020-02-23,0,0,,,,,,,8174,5763,10329,45169,30936,57135,45668,30543,58293,2.26904676015,2.09868811252,2.39955105137
2020-02-24,0,0,,,,,,,10383,7301,13208,55265,38155,69881,56051,37844,71501,2.26845041431,2.09826348576,2.39937646651
2020-02-25,0,0,,,,,,,16266,10891,20680,71244,49059,90040,72317,48735,92181,2.26764114792,2.0977260901,2.39913859562
2020-02-26,0,0,,,,,,,19659,13394,25029,90615,62333,114626,91976,62129,117210,2.26653968891,2.09703001165,2.39877898311
2020-02-27,0,0,,,,,,,21446,14497,27505,111774,76681,141712,113422,76626,144715,2.26503871618,2.0960652975,2.39826717088
2020-02-28,0,0,,,,,,,26090,17482,33820,137396,93882,174873,139512,94108,178535,2.26299059827,2.09468184619,2.39751991173
2020-02-29,1,1,,,,,,,31905,20824,42003,168625,114305,215898,171417,114932,220538,2.26019169504,2.09262056934,2.39646030096
2020-03-01,0,1,,,,,,,41437,26471,55156,208845,140089,269316,212854,141403,275694,2.25636247296,2.09009806762,2.39499894308
2020-03-02,5,6,,,,,,,51535,32533,69223,257969,171260,335301,264389,173936,344917,2.25112139452,2.08660419288,2.39293368266
2020-03-03,1,7,,,,,,,63963,40245,86636,318034,209072,416868,328352,214181,431553,2.24395189081,2.08229737756,2.38953540197
2020-03-04,4,11,,,,,,,78502,48746,107312,392222,255073,518549,406854,262927,538865,2.23416123275,2.07595098932,2.38437581254
2020-03-05,1,12,,,,,,,98194,60428,134947,485342,312196,646899,505048,323355,673812,2.22083426806,2.06629784135,2.3766199286
2020-03-06,2,14,,,,,,,120378,73319,166221,600506,382110,806324,625426,396674,840033,2.20278999876,2.05277925539,2.3649893859
2020-03-07,3,17,,,,,,,145497,88750,201656,740260,467016,1000557,770923,485424,1041689,2.17855680973,2.03387833041,2.34803374142
2020-03-08,4,21,,,,,,,173015,106804,238625,906444,569061,1230449,943938,592228,1280314,2.14639539392,2.00149907195,2.32423666267
2020-03-09,1,22,,,,,,,202204,128206,274499,1100475,691366,1494647,1146142,720434,1554813,2.10441239569,1.94355638693,2.29455061655
2020-03-10,6,28,,,,,,,232002,153462,310960,1322094,837263,1792537,1378144,873896,1865773,2.05081251663,1.86796992677,2.26261239602
2020-03-11,5,33,,,,,,,258646,176238,345734,1564474,1002557,2117530,1636790,1050134,2211507,1.98430853197,1.78360262507,2.23915960606
2020-03-12,10,43,,,,,,,280509,193957,373315,1825323,1182974,2465826,1917299,1244091,2584822,1.90462670895,1.68801685555,2.18584369401
2020-03-13,8,51,,,,,,,297368,206636,393573,2101245,1374996,2831851,2214667,1450727,2978395,1.81293286834,1.57114976707,2.116377081
2020-03-14,7,58,,,,,,,308978,214550,404949,2384133,1572004,3202907,2523645,1665277,3383344,1.71195630526,1.45609190155,2.04849618765
2020-03-15,12,70,,,,,,,316678,221403,415676,2668906,1772675,3576404,2840323,1886680,3799020,1.60569539961,1.32886779644,1.97975244234
2020-03-16,27,97,,,,,,,320929,226945,425806,2948398,1973420,3946851,3161252,2113625,4224826,1.49879442864,1.21410268275,1.894643123
2020-03-17,35,132,,,,,,,322645,231723,430838,3219508,2173055,4308234,3483897,2345348,4655664,1.39581839641,1.12081112137,1.79149006315
2020-03-18,59,191,,,,,,,322703,234738,431293,3478248,2368219,4652578,3806600,2580086,5086957,1.3006395916,1.04741831962,1.67306130121
2020-03-19,73,264,,,,,,,321636,237592,428702,3721382,2557980,4973469,4128236,2817678,5515659,1.21604447847,0.99222949194,1.54472815393
2020-03-20,99,363,,,,,,,319924,239940,426300,3943111,2738696,5264157,4448160,3057618,5941959,1.14357182534,0.94865574288,1.4409406193
2020-03-21,99,462,,,,,,,317682,241180,424581,4140416,2907958,5521801,4765842,3298798,6366540,1.08355326733,0.916950018892,1.33645294311
2020-03-22,110,572,,,,,,,315014,242003,420135,4309933,3062766,5739500,5080856,3540801,6786675,1.03532162717,0.894187354445,1.25292411408
2020-03-23,189,761,,,,,,,312059,242185,414102,4448977,3199805,5914193,5392915,3782986,7200777,0.997532924826,0.877988480227,1.1779294811
2020-03-24,239,1000,,,,,,,308858,241699,406506,4555630,3314999,6045305,5701773,4024685,7607283,0.968516447451,0.866513810307,1.11343378107
2020-03-25,324,1324,,,,,,,305447,241115,399298,4629076,3404297,6132562,6007220,4265800,8006581,0.946566568449,0.858168660614,1.06122974319
2020-03-26,408,1732,,,,,,,301819,239007,392940,4672249,3468466,6178843,6309039,4504807,8399521,0.930131156255,0.852466014157,1.02235850364
2020-03-27,518,2250,,,,,,,297955,235084,386009,4689695,3510216,6190690,6606994,4739891,8785530,0.91789971165,0.848134769027,0.993777623228
2020-03-28,633,2883,,,,,,,293860,230982,378569,4686187,3534406,6174923,6900854,4970873,9164099,0.908820357381,0.845324955698,0.977873560622
2020-03-29,586,3469,,,,,,,289569,226693,371169,4666778,3545693,6140441,7190423,5197566,9535268,0.902077481985,0.843073470345,0.965700466729
2020-03-30,692,4161,,,,,,,285029,222464,364101,4635128,3545293,6088459,7475452,5420030,9899369,0.89705343613,0.841551681404,0.958257923124
2020-03-31,1085,5246,,,,,,,280289,218059,356821,4594488,3534563,6019605,7755741,5638089,10256190,0.893287939143,0.840281230471,0.952155735242
2020-04-01,1172,6418,,,,,,,275366,213668,349409,4547208,3514553,5938757,8031107,5851757,10605599,0.890441668556,0.839308399667,0.948980442112
2020-04-02,1503,7921,,,,,,,270283,209138,342328,4494789,3487161,5850694,8301390,6060895,10947927,0.888266242965,0.838304292969,0.946829137132
2020-04-03,1392,9313,,,,,,,265068,204727,335851,4438221,3452681,5758826,8566458,6265622,11283778,0.886580661086,0.837605675977,0.944987936155
2020-04-04,1523,10836,,,,,,,259744,200347,328822,4378041,3411741,5662414,8826202,6465969,11612600,0.885253365854,0.836766352972,0.943444029766
2020-04-05,1590,12426,,,,,,,254344,196079,322422,4314703,3365645,5561529,9080546,6662048,11935022,0.884188857593,0.836207202445,0.942114645994
2020-04-06,1770,14196,,,,,,,248900,191674,315735,4248589,3314688,5458419,9329446,6853722,12250757,0.883317830346,0.835721805907,0.94119699675
2020-04-07,2571,16767,,,,,,,243446,187432,309029,4179976,3259600,5354557,9572892,7041154,12559786,0.882589964475,0.835185132956,0.940437479436
2020-04-08,2146,18913,,,,,,,238013,183059,302349,4109132,3200766,5251396,9810905,7224213,12862135,0.881968687992,0.834784586995,0.939784527004
2020-04-09,2228,21141,,,,,,,232629,178713,295580,4036314,3138225,5148415,10043534,7402926,13157715,0.881427381201,0.834395077136,0.939211444937
2020-04-10,2218,23359,,,,,,,227316,174510,288926,3961810,3073575,5044984,10270850,7577436,13446641,0.880946632036,0.833815628915,0.938674892066
2020-04-11,2119,25478,,,,,,,222092,170356,282447,3885947,3008722,4941840,10492942,7747792,13729088,0.880510751726,0.833409892879,0.938225739905
2020-04-12,1816,27294,,,,,,,216972,166273,276331,3809059,2943924,4839873,10709914,7914065,14005419,0.880110348781,0.832998831734,0.937824827775
2020-04-13,1946,29240,,,,,,,211963,162165,270135,3731453,2879344,4738982,10921877,8076230,14275554,0.879737956503,0.832647504953,0.937486552583
2020-04-14,2455,31695,,,,,,,207071,158164,264314,3653496,2815020,4639252,11128948,8234394,14539868,0.879389279144,0.832302608851,0.937164696411
2020-04-15,2609,34304,,,,,,,202300,154302,258716,3575507,2751265,4541153,11331248,8388696,14798584,0.879068877575,0.831974948746,0.936824688448
2020-04-16,2176,36480,,,,,,,197648,150549,253341,3497789,2688167,4445079,11528896,8539245,15051925,0.878763546484,0.831698571899,0.936479348756
2020-04-17,2093,38573,,,,,,,193115,146872,247904,3420621,2625937,4350656,11722011,8686117,15299829,0.878474960132,0.831403543517,0.936169211953
2020-04-18,1960,40533,,,,,,,188699,143214,242713,3344252,2564469,4257519,11910710,8829331,15542542,0.87820195513,0.831163555088,0.935830027868
2020-04-19,1931,42464,,,,,,,184397,139565,237850,3268905,2503718,4166564,12095107,8968896,15780392,0.877944394691,0.8309391468,0.935559881945
2020-04-20,2186,44650,,,,,,,180205,136097,232999,3194766,2443750,4077183,12275312,9104993,16013391,0.877702420913,0.830719998806,0.935285897976
2020-04-21,2548,47198,,,,,,,176121,132650,228421,3121988,2384726,3989933,12451433,9237643,16241812,0.877477238144,0.830525944867,0.93507916223
2020-04-22,2434,49632,,,,,,,172142,129271,223927,3050684,2326547,3904946,12623575,9366914,16465739,0.877270244074,0.830345133686,0.934766699109
2020-04-23,2466,52098,,,,,,,168266,126088,219620,2980936,2269541,3822348,12791841,9493002,16685359,0.877085327111,0.830180827364,0.934490957792
2020-04-24,2154,54252,,,,,,,164490,122728,215564,2912797,2213516,3742465,12956331,9615730,16900923,0.876927304912,0.829965900201,0.934319051643
2020-04-25,1698,55950,,,,,,,160814,119601,211533,2846295,2158554,3665197,13117145,9735331,17112456,0.87680273805,0.829826492611,0.934062902543
2020-04-26,1329,57279,,,,,,,157235,116511,207539,2781437,2104663,3590399,13274380,9851842,17319995,0.876721054931,0.829714119864,0.933912698189
2020-04-27,1466,58745,,,,,,,153753,113517,203776,2718219,2051871,3517932,13428133,9965359,17523771,0.876694376061,0.829550303765,0.933655152634
2020-04-28,2241,60986,,,,,,,150366,110352,200023,2656623,2000029,3447893,13578499,10075711,17723794,0.876739248713,0.829395816532,0.933478705204
2020-04-29,2521,63507,,,,,,,147076,107455,196404,2596628,1949294,3380034,13725575,10183166,17920198,0.876877754087,0.829274552066,0.933246216194
2020-04-30,2322,65829,,,,,,,143881,104509,192915,2538209,1899473,3314268,13869456,10287675,18113113,0.877138923649,0.829189796427,0.933356748905
2020-05-01,1891,67720,,,,,,,140784,101704,189495,2481345,1850600,3250443,14010240,10389379,18302608,0.877560715274,0.829222883695,0.933327183409
2020-05-02,1692,69412,,,,,,,137785,99070,186276,2426015,1802773,3188828,14148025,10488449,18488884,0.878192032031,0.82931976749,0.93332393591
2020-05-03,1120,70532,,,,,,,134885,96475,183219,2372201,1756009,3129337,14282910,10584924,18672103,0.87909466537,0.829272779769,0.933509812519
2020-05-04,1333,71865,,,,,,,132089,94023,180300,2319893,1710445,3071783,14414999,10678947,18852403,0.880344652417,0.829427964427,0.93399921636
2020-05-05,2318,74183,,,,,,,129402,91522,177372,2269090,1665846,3016149,14544401,10770469,19029775,0.882032150315,0.829525269161,0.935136380471
2020-05-06,2364,76547,,,,,,,126826,89151,174610,2219794,1622326,2962326,14671227,10859620,19204385,0.884258598036,0.829551807136,0.939690802661
2020-05-07,1934,78481,,,,,,,124368,86996,172005,2172020,1580033,2910393,14795595,10946616,19376390,0.887129861935,0.829668537009,0.951486508975
2020-05-08,1747,80228,,,,,,,122035,84832,169391,2125789,1538757,2860156,14917630,11031448,19545781,0.890744858877,0.829852090859,0.969308431102
2020-05-09,1488,81716,,,,,,,119837,82819,167051,2081136,1498831,2811635,15037467,11114267,19712832,0.895181411371,0.830286380046,0.991944248939
2020-05-10,893,82609,,,,,,,117784,80987,164791,2038106,1460203,2764886,15155251,11195254,19877623,0.900484469854,0.830746815066,1.02024431619
2020-05-11,1014,83623,,,,,,,115887,79262,162933,1996758,1422943,2720273,15271138,11274516,20040556,0.906663730081,0.831617518974,1.0506247807
2020-05-12,1627,85250,,,,,,,114160,77674,161123,1957164,1387095,2677616,15385298,11352190,20201679,0.913704064706,0.831829017248,1.08060292146
2020-05-13,1764,87014,,,,,,,112617,76143,159532,1919415,1352887,2637117,15497915,11428333,20361211,0.921582986407,0.832271963238,1.10890748206
2020-05-14,1783,88797,,,,,,,111274,74868,158190,1883613,1320302,2598895,15609189,11503201,20519401,0.930282746055,0.832686639745,1.13609482248
2020-05-15,1681,90478,,,,,,,110146,73777,157037,1849878,1289575,2563007,15719335,11576978,20676438,0.939789768432,0.83341830475,1.1596372372
2020-05-16,1216,91694,,,,,,,109248,72837,156303,1818341,1260719,2529801,15828583,11649815,20832741,0.950087027639,0.834460059939,1.1791547437
2020-05-17,758,92452,,,,,,,108593,72106,155729,1789149,1233764,2499235,15937176,11721921,20988470,0.961149953825,0.835360299718,1.1958142475
2020-05-18,1172,93624,,,,,,,108195,71531,155568,1762460,1208833,2471558,16045371,11793452,21144038,0.972946160837,0.836941570126,1.21218670706
2020-05-19,1552,95176,,,,,,,108068,71155,155603,1738438,1185979,2446829,16153439,11864607,21299641,0.985426860017,0.83899659351,1.23294918768
2020-05-20,1526,96702,,,,,,,108221,71048,156009,1717258,1165533,2425435,16261660,11935655,21455650,0.998502642856,0.841717569127,1.24423421578
2020-05-21,1217,97919,,,,,,,108666,71085,156889,1699099,1147505,2407678,16370326,12006740,21612539,1.01201647352,0.845335491636,1.2531780315
2020-05-22,1244,99163,,,,,,,109412,71463,158183,1684143,1132021,2393818,16479738,12078203,21770722,1.02573965378,0.850430209235,1.26026892608
2020-05-23,1109,100272,,,,,,,110470,72070,159664,1672578,1119314,2384051,16590208,12150273,21930386,1.03940540433,0.857507535865,1.27333327837
2020-05-24,622,100894,,,,,,,111848,72928,161470,1664589,1109483,2378432,16702056,12223201,22091856,1.05276798168,0.86570594215,1.28417918388
2020-05-25,548,101442,,,,,,,113557,74096,163682,1660362,1102652,2377286,16815613,12297297,22255538,1.06565633535,0.873013594384,1.29196659944
2020-05-26,662,102104,,,,,,,115615,75364,166417,1660090,1098819,2380721,16931228,12372661,22421955,1.07799519529,0.87685626866,1.29775399673
2020-05-27,1518,103622,,,,,,,118033,77102,169342,1663964,1098309,2388893,17049261,12449763,22591297,1.08978908857,0.87816639495,1.30916206528
2020-05-28,1178,104800,,,,,,,120819,79068,172935,1672165,1101299,2402241,17170080,12528831,22764232,1.10108595192,0.879751534737,1.31512112245
2020-05-29,1160,105960,,,,,,,123984,81369,177344,1684876,1107864,2421334,17294064,12610200,22941576,1.1119398003,0.881998595489,1.32552324712
2020-05-30,963,106923,,,,,,,127546,84016,182072,1702275,1118161,2446314,17421610,12694216,23123648,1.1224303648,0.885086786952,1.33558531567
2020-05-31,581,107504,,,,,,,131521,87043,187216,1724549,1132421,2477170,17553131,12781259,23310864,1.1326127102,0.888337744987,1.345151035
2020-06-01,776,108280,,,,,,,135933,90324,192627,1751889,1150673,2514006,17689064,12871583,23503491,1.14253217807,0.893345934385,1.35053928541
2020-06-02,1068,109348,,,,,,,140797,93932,199070,1784490,1173107,2557445,17829861,12965515,23702561,1.15216326832,0.900692698175,1.3528630087
2020-06-03,1007,110355,,,,,,,146133,97805,206143,1822556,1199774,2607916,17975994,13063320,23908704,1.16142878722,0.91385122965,1.35436051045
2020-06-04,1023,111378,,,,,,,151963,102114,213161,1866298,1230861,2665019,18127957,13165434,24121865,1.17020032072,0.926490335402,1.35557522707
2020-06-05,914,112292,,,,,,,158305,106847,220646,1915936,1266647,2728746,18286262,13272281,24342511,1.17835243273,0.931478379002,1.35612919808
2020-06-06,659,112951,,,,,,,165176,111772,229484,1971700,1306976,2800009,18451438,13384053,24571995,1.1857935376,0.93591192299,1.35611869599
2020-06-07,438,113389,,,,,,,172597,117151,239626,2033827,1352068,2879908,18624035,13501204,24811621,1.1924369391,0.942686511327,1.35695587172
2020-06-08,519,113908,,,,,,,180583,123109,251017,2102562,1402257,2969361,18804618,13624313,25062638,1.19824017326,0.951809601906,1.35703083969
2020-06-09,950,114858,,,,,,,189144,129291,262805,2178149,1457463,3068375,18993762,13753604,25325443,1.20315087354,0.965501081572,1.3564524755
2020-06-10,901,115759,,,,,,,198286,135864,275482,2260820,1517970,3177321,19192048,13889468,25600925,1.20714945064,0.982502466038,1.35694314501
2020-06-11,871,116630,,,,,,,208011,142922,288703,2350797,1583795,3296587,19400059,14032390,25889628,1.2102346256,1.00669766016,1.35767244462
2020-06-12,828,117458,,,,,,,218309,150413,303239,2448287,1655152,3426782,19618368,14182803,26192867,1.21238737405,1.03429579263,1.35694188812
2020-06-13,759,118217,,,,,,,229165,158262,317138,2553468,1732062,3566522,19847533,14341065,26510005,1.21360911314,1.05646297183,1.3561650007
2020-06-14,308,118525,,,,,,,240552,166353,331271,2666474,1814406,3715708,20088085,14507418,26841276,1.21386301094,1.05395598492,1.35624040262
2020-06-15,394,118919,,,,,,,252430,174956,346396,2787383,1902319,3874890,20340515,14682374,27187672,1.2131528324,1.04889456219,1.35643705095
2020-06-16,838,119757,,,,,,,264750,184349,362731,2916199,1996338,4045030,20605265,14866723,27550403,1.21145379602,1.03972088996,1.35613717404
2020-06-17,744,120501,,,,,,,277446,193476,377771,3052849,2095888,4223804,20882711,15060199,27928174,1.20878310877,1.03220551401,1.35709750114
2020-06-18,718,121219,,,,,,,290441,202973,393799,3197157,2201066,4411536,21173152,15263172,28321973,1.20517199715,1.02542727411,1.35786423688
2020-06-19,670,121889,,,,,,,303641,213205,409035,3348835,2312166,4607499,21476793,15476377,28731008,1.20063666423,1.01246446011,1.35794590204
2020-06-20,604,122493,,,,,,,316939,223270,424786,3507469,2428597,4811708,21793732,15699647,29155794,1.19521051382,1.00481070022,1.35662576644
2020-06-21,285,122778,,,,,,,330214,233897,441406,3672507,2550710,5023694,22123946,15933544,29597200,1.18891789252,0.996609328323,1.35771665172
2020-06-22,389,123167,,,,,,,343339,244593,457105,3843249,2678122,5241204,22467285,16178137,30054305,1.181851399,0.987891936564,1.35697469861
2020-06-23,847,124014,,,,,,,356181,255316,473149,4018847,2810277,5463329,22823466,16433453,30527454,1.17412782904,0.982584874361,1.35626153401
2020-06-24,759,124773,,,,,,,368612,265688,486974,4198315,2946622,5687473,23192078,16699141,31014428,1.16588237921,0.976637795041,1.35515722473
2020-06-25,551,125324,,,,,,,380513,275803,499965,4380542,3086503,5911949,23572591,16974944,31514393,1.15726194141,0.972311017922,1.35456257805
2020-06-26,617,125941,,,,,,,391779,285777,512373,4564311,3229312,6135602,23964370,17260721,32026766,1.14838137564,0.967233631021,1.35424799219
2020-06-27,504,126445,,,,,,,402323,295405,525616,4748324,3374289,6358012,24366693,17556126,32552382,1.13936379702,0.960740668027,1.35250462588
2020-06-28,273,126718,,,,,,,412076,304751,535588,4931235,3520808,6576496,24778769,17860877,33087970,1.13029513134,0.957055711859,1.3504639771
2020-06-29,377,127095,,,,,,,420988,312986,546500,5111672,3667486,6791801,25199757,18173863,33634470,1.12124827622,0.952058038811,1.34922571757
2020-06-30,625,127720,,,,,,,429027,320992,555748,5288269,3813607,7001252,25628784,18494855,34190218,1.11226610633,0.948922122627,1.34818956642
2020-07-01,694,128414,,,,,,,436178,328029,564315,5459697,3957437,7202977,26064962,18822884,34754533,1.10334990261,0.943553125837,1.34510753715
2020-07-02,727,129141,,,,,,,442437,333980,570950,5624688,4098090,7396251,26507399,19156864,35325483,1.09448908349,0.939499242931,1.34062514322
2020-07-03,660,129801,,,,,,,447815,339407,578114,5782061,4234608,7580635,26955214,19496271,35903597,1.08565832584,0.936134685042,1.33527491896
2020-07-04,265,130066,,,,,,,452329,343948,583099,5930749,4365392,7754726,27407543,19840219,36486696,1.07686024517,0.933586542844,1.3267315691
2020-07-05,288,130354,,,,,,,456006,347290,587254,6069816,4489417,7917215,27863549,20187509,37073950,1.06812486406,0.928694833411,1.31512519825
2020-07-06,355,130709,,,,,,,458878,349947,589329,6198479,4605416,8065152,28322427,20537456,37663279,1.05951044272,0.925837726277,1.30497563424
2020-07-07,1222,131931,,,,,,,460983,352357,590561,6316123,4713100,8198603,28783410,20889813,38253840,1.05109007625,0.923314718211,1.2985512503
2020-07-08,863,132794,,,,,,,462361,354056,592049,6422304,4811729,8317496,29245771,21243869,38845889,1.0429403108,0.921491252401,1.2954374091
2020-07-09,1003,133797,,,,,,,463058,355161,592140,6516750,4901087,8422667,29708829,21599030,39438029,1.03512936603,0.919155435697,1.28948207146
2020-07-10,824,134621,,,,,,,463119,355829,590986,6599356,4981024,8513693,30171948,21954859,40029015,1.02770957204,0.916852532049,1.27938964822
2020-07-11,690,135311,,,,,,,462589,356250,590756,6670166,5051425,8592061,30634537,22311109,40619771,1.02072094023,0.912619665092,1.26324022068
2020-07-12,459,135770,,,,,,,461514,355894,589021,6729358,5111841,8655439,31096051,22667003,41208792,1.01419019201,0.910486524128,1.25387736788
2020-07-13,367,136137,,,,,,,459939,355194,587590,6777221,5162245,8707411,31555990,23022197,41796382,1.00812723761,0.909109022052,1.24149770689
2020-07-14,926,137063,,,,,,,457905,354257,584840,6814138,5203473,8745715,32013895,23376454,42381222,1.00252416936,0.907188589456,1.22776885608
2020-07-15,968,138031,,,,,,,455454,352374,582286,6840564,5234832,8772234,32469349,23728828,42963508,0.997360656431,0.905861762416,1.21131313478
2020-07-16,943,138974,,,,,,,452622,350786,578174,6857009,5257568,8786069,32921971,24079614,43541682,0.992613104903,0.904737435452,1.19950183401
2020-07-17,930,139904,,,,,,,449445,348641,574345,6864017,5272222,8789470,33371416,24428255,44116027,0.988261186803,0.903883512555,1.18347333089
2020-07-18,868,140772,,,,,,,445956,345516,569454,6862158,5278329,8780833,33817372,24773771,44685481,0.9842883816,0.902109062019,1.1640699682
2020-07-19,447,141219,,,,,,,442185,342727,564633,6852014,5277126,8762378,34259557,25116498,45250114,0.980678682137,0.899262522208,1.14675248095
2020-07-20,514,141733,,,,,,,438161,339575,559996,6834170,5269416,8735133,34697718,25456073,45810110,0.977413547705,0.895887347204,1.13450400183
2020-07-21,1107,142840,,,,,,,433912,336061,554566,6809204,5255526,8700361,35131630,25792134,46364676,0.974470997852,0.893634223631,1.11025879283
2020-07-22,1216,144056,,,,,,,429461,332336,548584,6777682,5235492,8658354,35561091,26124470,46913260,0.971826225978,0.892104756697,1.08873022334
2020-07-23,1094,145150,,,,,,,424833,328828,543481,6740154,5210246,8609791,35985924,26453298,47456741,0.969452631402,0.890711789858,1.07186810184
2020-07-24,1132,146282,,,,,,,420048,325261,538100,6697144,5180322,8555753,36405972,26778559,47994841,0.967322882086,0.888790854723,1.06228345297
2020-07-25,899,147181,,,,,,,415127,321228,532423,6649152,5145694,8497187,36821099,27099787,48527264,0.965410065214,0.887736043674,1.05533432235
2020-07-26,472,147653,,,,,,,410089,317130,526864,6596653,5106535,8433288,37231188,27416917,49054128,0.963688885589,0.887340614063,1.04850097983
2020-07-27,1120,148773,,,,,,,404952,312953,520719,6540091,5063543,8364973,37636140,27729870,49574847,0.962136663298,0.886603611903,1.04168998367
2020-07-28,1374,150147,,,,,,,399732,308743,514921,6479884,5017032,8292301,38035872,28038613,50089768,0.960733846931,0.88593184132,1.03729872809
2020-07-29,1432,151579,,,,,,,394445,304312,509394,6416424,4967027,8216866,38430317,28342925,50599162,0.959463905887,0.885312453638,1.03598748139
2020-07-30,1209,152788,,,,,,,389104,299616,503556,6350074,4914207,8138169,38819421,28642541,51102718,0.958312699703,0.884735525431,1.0349606171
2020-07-31,1243,154031,,,,,,,383724,294825,497582,6281176,4858186,8057619,39203145,28937366,51600300,0.957267618774,0.88419344285,1.03139733135
2020-08-01,1115,155146,,,,,,,378316,289783,491312,6210046,4799270,7974640,39581461,29227149,52091612,0.956316838255,0.883625238545,1.0291079275
2020-08-02,403,155549,,,,,,,372891,284876,485841,6136981,4738589,7891109,39954352,29512025,52577453,0.955448907646,0.883071903456,1.02655121734
2020-08-03,530,156079,,,,,,,367459,280200,480071,6062255,4676037,7806627,40321811,29792225,53057524,0.954652704995,0.882714810625,1.02555378308
2020-08-04,1378,157457,,,,,,,362029,275382,474018,5986122,4611825,7720726,40683840,30067607,53531542,0.953917636838,0.882373779734,1.02488594479
2020-08-05,1376,158833,,,,,,,356610,270435,468402,5908820,4546182,7634623,41040450,30338042,53999944,0.953233919764,0.882041378063,1.02421493846
2020-08-06,1253,160086,,,,,,,351208,265131,462919,5830567,4478961,7548998,41391658,30603173,54462863,0.952592816404,0.881546768671,1.02354070488
2020-08-07,1242,161328,,,,,,,345832,260143,457792,5751566,4410268,7463368,41737490,30863316,54920655,0.951986765061,0.881147013658,1.02292965115
2020-08-08,1077,162405,,,,,,,340487,255038,452319,5672005,4340035,7377639,42077977,31118354,55372974,0.951409397821,0.880795051356,1.02235390934
2020-08-09,511,162916,,,,,,,335179,249955,446564,5592056,4268754,7291827,42413156,31368309,55819538,0.950855472361,0.880452753637,1.021762011
2020-08-10,527,163443,,,,,,,329912,244647,441044,5511879,4196257,7206029,42743068,31612956,56260582,0.95032075121,0.880120502188,1.02109997985
2020-08-11,1064,164507,,,,,,,324692,239466,435531,5431619,4122750,7120852,43067760,31852422,56696113,0.949801858202,0.879796338823,1.02054504646
2020-08-12,1505,166012,,,,,,,319521,234626,430232,5351407,4048613,7036169,43387281,32087048,57126345,0.949296133286,0.8794806751,1.01999132469
2020-08-13,1070,167082,,,,,,,314402,229817,425156,5271365,3974109,6951952,43701683,32316865,57551501,0.948801498311,0.879173219478,1.01943784971
2020-08-14,1338,168420,,,,,,,309339,224979,419912,5191600,3899471,6868333,44011022,32541844,57971413,0.948316339852,0.878873710919,1.01888604329
2020-08-15,1034,169454,,,,,,,304333,220122,414243,5112210,3824768,6785016,44315355,32761966,58385656,0.947839410813,0.878770384678,1.01832862252
2020-08-16,571,170025,,,,,,,299386,215167,409403,5033280,3750155,6703127,44614741,32977133,58795059,0.947369750001,0.878190669368,1.01776993405
2020-08-17,446,170471,,,,,,,294500,210623,404848,4954890,3675903,6622147,44909241,33187756,59199907,0.946906617686,0.8774511102,1.01720917463
2020-08-18,1325,171796,,,,,,,289675,205896,399885,4877106,3601603,6541974,45198916,33393652,59599792,0.946449444707,0.877084660801,1.01667459125
2020-08-19,1353,173149,,,,,,,284913,201250,394638,4799990,3527466,6462597,45483829,33594902,59994430,0.945997792699,0.876641058648,1.01614958374
2020-08-20,1079,174228,,,,,,,280214,196594,389380,4723595,3453619,6383573,45764043,33791496,60383810,0.94555132326,0.876224581635,1.01562287433
2020-08-21,1105,175333,,,,,,,275578,192104,384904,4647964,3380589,6305553,46039621,33983600,60768714,0.945109774189,0.875830775886,1.01509445754
2020-08-22,982,176315,,,,,,,271006,187577,380426,4573139,3308023,6228180,46310627,34171177,61149140,0.944672941256,0.875456209067,1.01456434336
2020-08-23,450,176765,,,,,,,266499,183482,376124,4499151,3236465,6151980,46577126,34354659,61525264,0.944240664254,0.875098226514,1.01403255313
2020-08-24,442,177207,,,,,,,262319,179500,372195,4426291,3166004,6077602,46839445,34534159,61897459,0.944795879881,0.87637490125,1.01496480458
2020-08-25,1239,178446,,,,,,,258196,175516,368067,4354574,3096868,6004616,47097641,34709675,62265526,0.94535821703,0.876416968926,1.01721253164
2020-08-26,1225,179671,,,,,,,254141,171607,363982,4284024,3029004,5933064,47351782,34881282,62629508,0.945927169491,0.877295118541,1.01855675417
2020-08-27,1111,180782,,,,,,,250168,167881,359928,4214670,2962254,5862761,47601950,35049163,62989436,0.946502687269,0.877712692173,1.01820812499
2020-08-28,971,181753,,,,,,,246300,164271,355846,4146568,2896705,5793458,47848250,35213434,63345282,0.947084710009,0.878949718955,1.01885930581
2020-08-29,958,182711,,,,,,,242563,160820,351875,4079792,2832544,5725436,48090813,35374254,63697157,0.947673163739,0.878922340511,1.02125635431
2020-08-30,310,183021,,,,,,,238937,157254,348235,4014395,2769672,5659440,48329750,35531508,64045392,0.948267935695,0.878778878744,1.02294866173
2020-08-31,573,183594,,,,,,,235403,153929,344536,3950412,2708432,5594585,48565153,35685437,64389928,0.948868869879,0.879172592291,1.02429579471
2020-09-01,1067,184661,,,,,,,231962,150700,341280,3887873,2648506,5531030,48797115,35836137,64731208,0.949475847947,0.880565843424,1.02738386748
2020-09-02,1056,185717,,,,,,,228612,147609,338296,3826811,2590218,5469454,49025727,35983746,65069504,0.950088780141,0.879987249333,1.02883103671
2020-09-03,1070,186787,,,,,,,225363,144527,335752,3767261,2533493,5410568,49251090,36128273,65405256,0.950707577504,0.87884137742,1.02923180532
2020-09-04,965,187752,,,,,,,222213,141610,332645,3709260,2478507,5353819,49473303,36269883,65737901,0.95133214941,0.878436326642,1.03112553233
2020-09-05,783,188535,,,,,,,219157,138780,329723,3652840,2425181,5298622,49692460,36408663,66067624,0.951962388176,0.878287579582,1.03266082846
2020-09-06,403,188938,,,,,,,216192,135904,327118,3598026,2373506,5245303,49908652,36544567,66394742,0.952598186038,0.87759804124,1.03612593438
2020-09-07,267,189205,,,,,,,213317,133155,324757,3544843,2323177,5193920,50121969,36677722,66719499,0.953239441264,0.876581653845,1.03964236497
2020-09-08,445,189650,,,,,,,210531,130473,322307,3493056,2274147,5144019,50332500,36808195,67041806,0.953886055335,0.875079260611,1.04147320071
2020-09-09,1206,190856,,,,,,,207836,128019,320285,3442696,2226648,5096220,50540336,36936214,67362091,0.954537929104,0.87411126673,1.04322485877
2020-09-10,907,191763,,,,,,,205230,125588,318194,3393785,2180628,5050419,50745566,37061802,67680285,0.955194958498,0.872954240407,1.04475041742
2020-09-11,1213,192976,,,,,,,202711,123070,316294,3346328,2135817,5006770,50948277,37184872,67996579,0.95585703585,0.872706646238,1.04589351603
2020-09-12,714,193690,,,,,,,200277,120588,314390,3300305,2092133,4965303,51148554,37305460,68310969,0.956524052553,0.871876802835,1.04904944306
2020-09-13,,,760.451552431,549,1043,194450.451552,194239,194733,197929,118219,313031,3255671,2049530,4926454,51346483,37423679,68624000,0.957195899408,0.871240927184,1.05119772877
2020-09-14,,,745.582599782,536,1027,195196.034152,194775,195759,195666,115943,311757,3212401,2008216,4889980,51542149,37539622,68935757,0.957872465875,0.871163274948,1.05399655563
2020-09-15,,,730.976378894,522,1011,195927.010531,195298,196770,193488,113649,310644,3170486,1967933,4856099,51735637,37653271,69246401,0.958553638602,0.869535760571,1.05717360047
2020-09-16,,,716.642457096,509,997,196643.652988,195808,197766,191393,111434,309729,3129917,1928664,4824557,51927030,37764705,69556130,0.959239300986,0.867389106478,1.06040520264
2020-09-17,,,702.58983489,496,982,197346.242823,196304,198748,189381,109374,308756,3090686,1890425,4795025,52116411,37874079,69864886,0.959929333577,0.86575951645,1.06475213423
2020-09-18,,,688.82631197,483,967,198035.069135,196788,199714,187452,107228,307879,3052774,1853122,4767152,52303863,37981307,70172765,0.960623614343,0.86384674895,1.06862029553
2020-09-19,,,675.355687022,471,952,198710.424822,197259,200666,185604,105289,307072,3016165,1816799,4741577,52489467,38086596,70479837,0.96132201854,0.862073013134,1.07055822153
2020-09-20,,,662.181611425,459,938,199372.606434,197718,201604,183839,103323,306467,2980846,1781341,4718323,52673306,38189919,70786304,0.962024418236,0.860462936594,1.07402752977
2020-09-21,,,649.307670172,447,924,200021.914104,198165,202528,182155,101289,305719,2946808,1746727,4696931,52855461,38291208,71092023,0.962730681896,0.858552275928,1.07788509053
2020-09-22,,,636.737264407,435,911,200658.651368,198601,203438,180552,99325,306083,2914043,1712899,4678253,53036013,38390533,71398106,0.963440674219,0.856598385964,1.08143276913
2020-09-23,,,624.473246235,424,898,201283.124614,199026,204335,179030,97466,305938,2882541,1679893,4661884,53215043,38487999,71704044,0.964154256069,0.854859157293,1.0834036027
2020-09-24,,,612.512297694,413,885,201895.636912,199439,205219,177588,95771,305996,2852293,1647646,4647593,53392631,38583770,72010040,0.964871284328,0.853001263053,1.0862817591
2020-09-25,,,600.851826367,402,873,202496.488738,199842,206091,176228,94059,306845,2823292,1616119,4636245,53568859,38677829,72316885,0.965591611634,0.851119098626,1.08934377342
2020-09-26,,,589.489766097,392,861,203085.978504,200235,206951,174948,92483,307708,2795529,1585536,4627654,53743807,38770312,72624593,0.966315086058,0.84928351965,1.09260299137
2020-09-27,,,580.61819938,384,852,203666.596704,200620,207803,173749,90930,308828,2769001,1555879,4622083,53917556,38861242,72933421,0.967041550829,0.847538637947,1.09567389972
2020-09-28,,,571.963001896,376,843,204238.559706,200997,208645,172631,89354,310125,2743703,1527015,4619166,54090187,38950596,73243546,0.967770844088,0.845714689332,1.09823415181
2020-09-29,,,563.524359036,368,835,204802.084065,201365,209479,171594,87712,312014,2719631,1498784,4619414,54261781,39038308,73555560,0.968502798635,0.84389831402,1.10149554177
2020-09-30,,,555.302016309,360,828,205357.386081,201726,210306,170639,86178,313674,2696782,1471314,4622435,54432420,39124486,73869234,0.969237241638,0.842089404499,1.10474818042
2020-10-01,,,547.295721147,352,821,205904.681802,202079,211126,169766,84712,315977,2675156,1444592,4628673,54602186,39209198,74185211,0.96998363267,0.840287853464,1.10799097814
2020-10-02,,,539.505263818,345,814,206444.187066,202425,211939,168976,83247,318166,2654751,1418464,4638072,54771162,39292445,74503377,0.970735665338,0.838864982745,1.11122278961
2020-10-03,,,531.930461273,338,807,206976.117527,202764,212745,168269,81884,320652,2635568,1393120,4650834,54939431,39374329,74824029,0.971489793839,0.837536055877,1.11444241063
2020-10-04,,,524.570839437,331,799,207500.688367,203096,213544,167646,80573,322935,2617609,1368405,4666686,55107077,39454902,75146964,0.972251789551,0.83594262287,1.11764857466
2020-10-05,,,517.425694591,324,795,208018.114061,203420,214337,167107,79247,325657,2600878,1344331,4685860,55274184,39534149,75472621,0.973021491858,0.833719496861,1.12139059392
2020-10-06,,,510.494231705,318,788,208528.608293,203739,215125,166654,78020,329304,2585377,1321067,4709430,55440838,39612169,75801925,0.973794473708,0.832628774806,1.12582719011
2020-10-07,,,503.775651846,312,783,209032.383945,204051,215906,166287,76753,332470,2571112,1298498,4735794,55607125,39688922,76134395,0.974568461927,0.830195491469,1.13026727977
2020-10-08,,,497.269173005,305,776,209529.653118,204357,216682,166007,75613,335494,2558090,1276648,4765331,55773132,39764535,76469889,0.975343998368,0.829945742164,1.13367130859
2020-10-09,,,490.973865622,299,771,210020.626984,204657,217451,165816,74407,338832,2546318,1255286,4798149,55938948,39838942,76808721,0.976131221765,0.829640953695,1.13699119542
2020-10-10,,,484.88864877,293,766,210505.515632,204951,218216,165715,73308,343280,2535805,1234536,4834574,56104663,39912250,77152001,0.976926535426,0.829489051253,1.14029149655
2020-10-11,,,479.012324214,288,761,210984.527957,205239,218977,165706,72182,347236,2526563,1214236,4874094,56270369,39984432,77499237,0.977724246822,0.82840489674,1.1435704551
2020-10-12,,,473.343609585,282,758,211457.871566,205522,219733,165788,71092,352478,2518602,1194399,4917737,56436157,40055524,77851715,0.978522957756,0.827442571602,1.1468262159
2020-10-13,,,467.881268551,276,755,211925.752835,205799,220487,165965,70016,358545,2511936,1175060,4966157,56602122,40125540,78210260,0.979324281128,0.826408044105,1.15005681956
2020-10-14,,,462.62419842,271,752,212388.377033,206070,221237,166238,69035,364207,2506580,1156383,5018354,56768360,40194575,78574467,0.98012769639,0.825576515731,1.15326019623
2020-10-15,,,457.57128437,265,749,212845.948317,206336,221985,166609,68061,370068,2502550,1138266,5074761,56934969,40262636,78944535,0.980949850951,0.82547948726,1.15643415896
2020-10-16,,,452.721411028,261,746,213298.669728,206597,222731,167079,67080,375822,2499863,1120635,5134625,57102048,40329716,79320357,0.981776588212,0.825386095912,1.15957639676
2020-10-17,,,448.073494748,256,744,213746.743223,206854,223473,167652,66148,382672,2498539,1103538,5199151,57269700,40395864,79703029,0.982603790629,0.825230085492,1.16289496627
2020-10-18,,,443.626530325,251,743,214190.369754,207105,224215,168327,65254,389210,2498597,1086908,5267726,57438027,40461118,80092239,0.983430784312,0.824574932083,1.16530853959
2020-10-19,,,439.37973577,246,740,214629.749489,207351,224953,169110,64330,396316,2500061,1070664,5341119,57607137,40525448,80488555,0.984258650287,0.823107594975,1.16766206259
2020-10-20,,,435.332417638,241,738,215065.081907,207593,225690,170001,63452,403811,2502955,1054869,5419286,57777138,40588900,80892366,0.985088206432,0.822765465046,1.17048865282
2020-10-21,,,431.483972334,237,739,215496.565879,207831,226428,171003,62685,411765,2507305,1039532,5501756,57948141,40651585,81304131,0.98591734504,0.8226246059,1.1729531251
2020-10-22,,,427.833897924,232,739,215924.399777,208064,227166,172120,61893,420542,2513138,1024672,5589821,58120261,40713478,81724673,0.986751717044,0.822118299569,1.17534863545
2020-10-23,,,424.381822956,228,740,216348.7816,208293,227904,173354,61095,429428,2520484,1010155,5683746,58293615,40774573,82154101,0.987586397097,0.821280309539,1.17851427108
2020-10-24,,,421.127771392,224,742,216769.909372,208518,228645,174707,60364,438936,2529375,996110,5783839,58468322,40834937,82593037,0.988419355615,0.820444942763,1.18213870457
2020-10-25,,,418.071903341,220,744,217187.981275,208739,229387,176185,59617,448520,2539844,982416,5889068,58644507,40894554,83041557,0.989249734385,0.819382045266,1.18608149192
2020-10-26,,,415.21452514,216,746,217603.1958,208956,230131,177789,58992,458284,2551927,969224,6000099,58822296,40953546,83499841,0.990077940508,0.818575918873,1.18999689022
2020-10-27,,,412.556105157,213,750,218015.751905,209169,230879,179523,58300,469248,2565662,956433,6116859,59001819,41011846,83969089,0.990900022854,0.817380992198,1.19388215894
2020-10-28,,,410.09730757,209,754,218425.849213,209379,231631,181391,57543,480780,2581087,943960,6239098,59183210,41069389,84449869,0.991717954685,0.816971707255,1.19738901916
2020-10-29,,,407.839030182,205,759,218833.688243,209585,232388,183396,56902,492436,2598245,931826,6367333,59366606,41126291,84942305,0.992533467424,0.816650165393,1.20059911778
2020-10-30,,,405.782390693,202,764,219239.470634,209787,233150,185544,56325,505623,2617180,920090,6502895,59552150,41182616,85447928,0.993346082937,0.81571661674,1.20313878892
2020-10-31,,,403.928714367,198,770,219643.399348,209987,233918,187837,55686,518307,2637937,908698,6645383,59739987,41238302,85966235,0.994150756445,0.814758668928,1.20561779119
2020-11-01,,,402.27953221,195,776,220045.67888,210182,234691,190280,55122,533580,2660566,897674,6796294,59930267,41293424,86499815,0.994948433603,0.81457464549,1.20718780574
