date,actual_deaths,total_deaths,predicted_deaths_mean,predicted_deaths_lower,predicted_deaths_upper,predicted_total_deaths_mean,predicted_total_deaths_lower,predicted_total_deaths_upper,predicted_new_infected_mean,predicted_new_infected_lower,predicted_new_infected_upper,predicted_current_infected_mean,predicted_current_infected_lower,predicted_current_infected_upper,predicted_total_infected_mean,predicted_total_infected_lower,predicted_total_infected_upper,r_values_mean,r_values_lower,r_values_upper
2020-02-05,0,0,,,,,,,125,65,178,125,65,178,125,65,178,2.26439696494,2.1,2.4
2020-02-06,0,0,,,,,,,125,65,178,250,130,356,250,130,356,2.26438776743,2.09999117142,2.39999969818
2020-02-07,0,0,,,,,,,125,65,178,375,195,534,375,195,534,2.26438464968,2.09998829489,2.39999952681
2020-02-08,0,0,,,,,,,125,65,178,500,260,712,500,260,712,2.26438046242,2.09998448111,2.39999928537
2020-02-09,0,0,,,,,,,287,163,404,787,438,1103,787,423,1116,2.26437483368,2.09997942474,2.39999891049
2020-02-10,0,0,,,,,,,287,163,404,1075,607,1502,1074,586,1520,2.26436726012,2.09997272091,2.39999832973
2020-02-11,0,0,,,,,,,287,163,404,1362,773,1904,1361,749,1924,2.26435705978,2.09996383288,2.39999743653
2020-02-12,0,0,,,,,,,287,163,404,1649,937,2306,1648,912,2328,2.2643433075,2.09995204904,2.3999961368
2020-02-13,0,0,,,,,,,465,279,650,2115,1237,2935,2113,1191,2978,2.26432474661,2.09993642599,2.39999422428
2020-02-14,0,0,,,,,,,672,411,934,2787,1653,3863,2785,1602,3912,2.26426983835,2.09988348693,2.39996709839
2020-02-15,0,0,,,,,,,1212,750,1626,3999,2458,5450,3997,2352,5538,2.26423218528,2.09985139157,2.39995994785
2020-02-16,0,0,,,,,,,2406,1475,3093,6404,4061,8481,6403,3827,8631,2.26417407379,2.09980106926,2.39994317239
2020-02-17,0,0,,,,,,,3890,2532,4924,10294,6726,13317,10293,6359,13555,2.26409964464,2.09973694247,2.39992351505
2020-02-18,0,0,,,,,,,4306,2848,5461,14600,9616,18752,14599,9207,19016,2.26400200751,2.09965423004,2.39989841579
2020-02-19,0,0,,,,,,,5063,3411,6410,19663,13091,25119,19662,12618,25426,2.2638720811,2.09954591004,2.39986484277
2020-02-20,0,0,,,,,,,5201,3517,6600,24740,16555,31533,24863,16135,32026,2.26369669924,2.09940184921,2.39981778572
2020-02-21,0,0,,,,,,,5730,3933,7256,30345,20448,38591,30593,20068,39282,2.26345831669,2.09920889917,2.39975050058
2020-02-22,0,0,,,,,,,6813,4750,8637,37033,25179,47013,37406,24818,47919,2.26313690629,2.09896077976,2.39965552763
2020-02-23,0,0,,,,,,,8156,5770,10325,45064,30980,57085,45562,30588,58244,2.26270354966,2.09864515274,2.39951085881
2020-02-24,0,0,,,,,,,10363,7305,13202,55139,38203,69824,55925,37893,71446,2.26211675174,2.09823342809,2.39932202007
2020-02-25,0,0,,,,,,,16243,10902,20658,71094,49120,89965,72168,48795,92104,2.26131936354,2.09769537981,2.39904575357
2020-02-26,0,0,,,,,,,19632,13408,25012,90439,62409,114537,91800,62203,117116,2.26023253627,2.0969756868,2.39861489899
2020-02-27,0,0,,,,,,,21411,14503,27469,111562,76763,141588,113211,76706,144585,2.25874931547,2.09592601126,2.39802200025
2020-02-28,0,0,,,,,,,26046,17462,33744,137143,93943,174673,139257,94168,178329,2.25672231493,2.0943864386,2.39717028009
2020-02-29,1,1,,,,,,,31852,20819,41923,168323,114360,215619,171109,114987,220252,2.25394787587,2.09223403136,2.39589482026
2020-03-01,0,1,,,,,,,41368,26492,55072,208479,140163,268950,212477,141479,275324,2.25014591932,2.08967372363,2.39402031943
2020-03-02,5,6,,,,,,,51467,32592,69097,257540,171387,334816,263944,174071,344421,2.24493341943,2.08599858275,2.39126105408
2020-03-03,1,7,,,,,,,63881,40246,86270,317531,209193,416026,327825,214317,430691,2.23779074508,2.08126709887,2.38719760613
2020-03-04,4,11,,,,,,,78400,48760,106894,391625,255203,517288,406225,263077,537585,2.22801965936,2.07451847634,2.38121719331
2020-03-05,1,12,,,,,,,98084,60516,134487,484646,312407,645169,504309,323593,672072,2.21469593667,2.0658934997,2.37251156995
2020-03-06,2,14,,,,,,,120227,73343,165782,599672,382343,804142,624536,396936,837854,2.1966247294,2.05230013109,2.35977360419
2020-03-07,3,17,,,,,,,145298,88891,201139,739240,467392,997863,769834,485827,1038993,2.17231503503,2.0314918986,2.34202061182
2020-03-08,4,21,,,,,,,172750,107107,238003,905177,569736,1227123,942584,592934,1276996,2.14000348807,2.00250003308,2.31627694173
2020-03-09,1,22,,,,,,,201856,128207,273881,1098877,692038,1490697,1144440,721141,1550877,2.0977724916,1.94496523661,2.27891738705
2020-03-10,6,28,,,,,,,231556,153519,310258,1320070,837988,1787880,1375996,874660,1861135,2.04381267488,1.86984618172,2.24813716496
2020-03-11,5,33,,,,,,,258076,176366,344884,1561904,1003403,2112047,1634072,1051026,2206019,1.97684940308,1.78408048721,2.21188147479
2020-03-12,10,43,,,,,,,279794,193674,372267,1822066,1183530,2459321,1913866,1244700,2578286,1.89666528576,1.68980295024,2.16220215088
2020-03-13,8,51,,,,,,,296497,206335,392098,2097152,1375250,2823927,2210363,1451035,2970384,1.80453105188,1.57092668164,2.1092423573
2020-03-14,7,58,,,,,,,307958,214367,403465,2379063,1572088,3193584,2518321,1665402,3373849,1.70330991256,1.45272327701,2.0462740365
2020-03-15,12,70,,,,,,,315534,220763,413236,2662745,1772115,3564743,2833855,1886165,3787085,1.59712330814,1.3286672407,1.97772895968
2020-03-16,27,97,,,,,,,319681,226674,423220,2941058,1972551,3932703,3153536,2112839,4210305,1.49068978333,1.21849006314,1.89327716409
2020-03-17,35,132,,,,,,,321307,230948,427638,3210899,2171313,4291056,3474843,2343787,4637943,1.38858259889,1.12427567394,1.78773659671
2020-03-18,59,191,,,,,,,321278,234333,427834,3468296,2366038,4632382,3796121,2578120,5065777,1.29461856135,1.05203927283,1.66881818358
2020-03-19,73,264,,,,,,,320115,237220,424787,3710011,2555378,4949897,4116236,2815340,5490564,1.21147760402,0.999633088322,1.54439699727
2020-03-20,99,363,,,,,,,318292,239518,422163,3930219,2735544,5237013,4434528,3054858,5912727,1.14056283428,0.963317115458,1.43125750559
2020-03-21,99,462,,,,,,,315920,240983,418484,4125912,2904571,5489082,4750448,3295841,6331211,1.08207189173,0.937616131202,1.33199864432
2020-03-22,110,572,,,,,,,313105,241670,414165,4293719,3058859,5701458,5063553,3537511,6745376,1.03523430745,0.919221341581,1.24664850294
2020-03-23,189,761,,,,,,,309989,241899,408412,4430958,3195284,5871188,5373542,3779410,7153788,0.998647559202,0.897254843384,1.16949653313
2020-03-24,239,1000,,,,,,,306619,241833,400552,4535721,3310539,5996989,5680161,4021243,7554340,0.970623715142,0.8792382803,1.10344223904
2020-03-25,324,1324,,,,,,,303037,240477,392710,4607202,3399066,6078352,5983198,4261720,7947050,0.949468217629,0.866795550008,1.0539820999
2020-03-26,408,1732,,,,,,,299241,238244,385754,4648367,3462286,6118278,6282439,4499964,8332804,0.933654536804,0.858561931054,1.01801053051
2020-03-27,518,2250,,,,,,,295217,234073,378323,4663790,3503257,6123409,6577656,4734037,8711127,0.921902298398,0.853167853741,0.991564503865
2020-03-28,633,2883,,,,,,,290973,230226,370887,4658265,3527055,6101344,6868629,4964263,9082014,0.913188540312,0.849237975182,0.975947341894
2020-03-29,586,3469,,,,,,,286548,225992,363618,4636855,3537843,6060695,7155177,5190255,9445632,0.906722774984,0.845704154285,0.963983398805
2020-03-30,692,4161,,,,,,,281888,221684,356164,4603210,3537389,6003163,7437065,5411939,9801796,0.901907971187,0.843314794461,0.957554505573
2020-03-31,1085,5246,,,,,,,277044,217122,348691,4560574,3526069,5928706,7714109,5629061,10150487,0.898300180783,0.841939493676,0.951731525353
2020-04-01,1172,6418,,,,,,,272032,212766,341362,4511298,3505974,5842966,7986141,5841827,10491849,0.895572727248,0.840911024366,0.948703111737
2020-04-02,1503,7921,,,,,,,266876,208284,334322,4456896,3478171,5750344,8253017,6050111,10826171,0.893486875003,0.839727967505,0.946477305359
2020-04-03,1392,9313,,,,,,,261600,203717,327995,4398381,3443077,5654531,8514617,6253828,11154166,0.891868908216,0.838687112333,0.94453501024
2020-04-04,1523,10836,,,,,,,256230,199315,320960,4336320,3401565,5554418,8770847,6453143,11475126,0.89059273789,0.838043468295,0.942988996882
2020-04-05,1590,12426,,,,,,,250797,195038,314323,4271196,3354679,5451452,9021644,6648181,11789449,0.889566952675,0.837320962565,0.941978696059
2020-04-06,1770,14196,,,,,,,245332,190559,307878,4203424,3302957,5346483,9266976,6838740,12097327,0.888725297007,0.836556360154,0.941069609351
2020-04-07,2571,16767,,,,,,,239869,186234,301260,4133304,3246958,5240579,9506845,7024974,12398587,0.888019725471,0.835981448053,0.940174838954
2020-04-08,2146,18913,,,,,,,234437,181665,294486,4061122,3186586,5135479,9741282,7206639,12693073,0.887415362067,0.835417645916,0.939555321039
2020-04-09,2228,21141,,,,,,,229062,177359,288131,3987147,3123316,5031630,9970344,7383998,12981204,0.886886853262,0.835001904399,0.93906486269
2020-04-10,2218,23359,,,,,,,223766,173047,281857,3911673,3057970,4928308,10194110,7557045,13263061,0.886415733971,0.834561209587,0.938567997545
2020-04-11,2119,25478,,,,,,,218566,168853,275662,3835023,2992625,4826048,10412676,7725898,13538723,0.885985425709,0.834188938088,0.938155185754
2020-04-12,1816,27294,,,,,,,213474,164857,269627,3757524,2927157,4725035,10626150,7890755,13808350,0.885590555295,0.83383696147,0.937793731932
2020-04-13,1946,29240,,,,,,,208498,160815,263567,3679474,2861930,4625111,10834648,8051570,14071917,0.88522238827,0.833510662001,0.937443485799
2020-04-14,2455,31695,,,,,,,203643,156858,257920,3601229,2797091,4526929,11038291,8208428,14329837,0.884876797723,0.833198844286,0.937085261574
2020-04-15,2609,34304,,,,,,,198910,153009,252217,3523094,2732994,4430464,11237201,8361437,14582054,0.884555478845,0.832882176186,0.936800046426
2020-04-16,2176,36480,,,,,,,194299,149219,247053,3445360,2669486,4336128,11431500,8510656,14829107,0.884249781639,0.832565537281,0.936447540709
2020-04-17,2093,38573,,,,,,,189809,145529,241908,3368293,2606779,4243691,11621309,8656185,15071015,0.883960447967,0.832245111681,0.936106828989
2020-04-18,1960,40533,,,,,,,185436,141872,236973,3292129,2544984,4152645,11806745,8798057,15307988,0.88368480479,0.832018346929,0.935818610138
2020-04-19,1931,42464,,,,,,,181179,138287,232082,3217078,2484001,4063766,11987924,8936344,15540070,0.883424549997,0.831782411088,0.935494985514
2020-04-20,2186,44650,,,,,,,177033,134750,227300,3143314,2423728,3976760,12164957,9071094,15767370,0.883179070794,0.831570220406,0.93519433891
2020-04-21,2548,47198,,,,,,,172996,131436,222735,3070978,2364601,3891663,12337953,9202530,15990105,0.882948444122,0.831385410838,0.934898166728
2020-04-22,2434,49632,,,,,,,169064,128078,218256,3000173,2306413,3808759,12507017,9330608,16208361,0.882734984416,0.831228875321,0.934582781183
2020-04-23,2466,52098,,,,,,,165236,124736,214077,2930971,2249448,3728472,12672253,9455344,16422438,0.882541978038,0.831016865083,0.934334056176
2020-04-24,2154,54252,,,,,,,161508,121490,209912,2863416,2193531,3650389,12833761,9576834,16632350,0.882373976532,0.830848543621,0.934186264153
2020-04-25,1698,55950,,,,,,,157880,118379,205892,2797530,2138814,3574554,12991641,9695213,16838242,0.882237173852,0.830738497337,0.934000148156
2020-04-26,1329,57279,,,,,,,154350,115244,201991,2733314,2085157,3500998,13145991,9810457,17040233,0.882140378039,0.830659296707,0.933776106439
2020-04-27,1466,58745,,,,,,,150917,112183,198279,2670757,2032443,3429749,13296908,9922640,17238512,0.88209510722,0.830569175797,0.933576375847
2020-04-28,2241,60986,,,,,,,147579,109178,194676,2609838,1980775,3360934,13444487,10031818,17433188,0.882117138896,0.830448315148,0.93348565373
2020-04-29,2521,63507,,,,,,,144337,106233,191180,2550532,1930118,3294258,13588824,10138051,17624368,0.882227588405,0.830349444931,0.933235729078
2020-04-30,2322,65829,,,,,,,141190,103495,187822,2492812,1880572,3229909,13730014,10241546,17812190,0.882454453626,0.830427080854,0.933317664506
2020-05-01,1891,67720,,,,,,,138141,100832,184483,2436654,1832157,3167365,13868155,10342378,17996673,0.882834551683,0.83044742187,0.933325083524
2020-05-02,1692,69412,,,,,,,135188,98071,181370,2382034,1784676,3106835,14003343,10440449,18178043,0.883415609885,0.830410032163,0.933345385398
2020-05-03,1120,70532,,,,,,,132335,95425,178372,2328932,1738206,3048233,14135678,10535874,18356415,0.884258306388,0.830456178122,0.933444956893
2020-05-04,1333,71865,,,,,,,129585,92889,175448,2277338,1692784,2991589,14265263,10628763,18531863,0.885437713592,0.830646373121,0.933936312031
2020-05-05,2318,74183,,,,,,,126942,90467,172596,2227247,1648478,2936869,14392205,10719230,18704459,0.887043191543,0.831050352442,0.935138272852
2020-05-06,2364,76547,,,,,,,124411,88134,169895,2178662,1605157,2884010,14516616,10807364,18874354,0.889175361984,0.831362346455,0.939831272097
2020-05-07,1934,78481,,,,,,,121997,85909,167288,2131595,1562970,2833021,14638613,10893273,19041642,0.891938670634,0.831734291411,0.952822377048
2020-05-08,1747,80228,,,,,,,119708,83710,164860,2086067,1521930,2783783,14758321,10976983,19206502,0.895428887142,0.831902144894,0.969431454017
2020-05-09,1488,81716,,,,,,,117552,81678,162501,2042112,1482108,2736352,14875873,11058661,19369003,0.899717430448,0.832154063721,0.989936617795
2020-05-10,893,82609,,,,,,,115542,79895,160326,1999773,1443614,2690770,14991415,11138556,19529329,0.904838346188,0.832544430151,1.01623943824
2020-05-11,1014,83623,,,,,,,113688,78206,158396,1959111,1406570,2647167,15105103,11216762,19687725,0.910786211728,0.832892915189,1.05039859201
2020-05-12,1627,85250,,,,,,,112005,76637,156580,1920199,1371021,2605464,15217108,11293399,19844305,0.917529542003,0.833780276148,1.08048947134
2020-05-13,1764,87014,,,,,,,110507,75237,155011,1883127,1337081,2565798,15327615,11368636,19999316,0.925033901408,0.834410956738,1.10926570017
2020-05-14,1783,88797,,,,,,,109209,74004,153640,1847999,1304857,2528257,15436824,11442640,20152956,0.933280592425,0.83581882814,1.13599867004
2020-05-15,1681,90478,,,,,,,108127,73031,152472,1814937,1274399,2492906,15544951,11515671,20305428,0.942270714019,0.837767500672,1.15952680411
2020-05-16,1216,91694,,,,,,,107277,72134,151628,1784073,1245708,2460046,15652228,11587805,20457056,0.952017356963,0.840094589658,1.1767269111
2020-05-17,758,92452,,,,,,,106671,71427,151129,1755555,1219074,2429793,15758899,11659232,20608185,0.962535321531,0.843570311132,1.1893018235
2020-05-18,1172,93624,,,,,,,106323,70893,151002,1729544,1194561,2402408,15865222,11730125,20759187,0.973830467321,0.848413139916,1.19894973539
2020-05-19,1552,95176,,,,,,,106247,70576,151162,1706205,1172270,2378102,15971469,11800701,20910349,0.985881111031,0.855113840478,1.22848915871
2020-05-20,1526,96702,,,,,,,106453,70477,151740,1685716,1152311,2357219,16077922,11871178,21062089,0.998608744757,0.864117496023,1.24061986023
2020-05-21,1217,97919,,,,,,,106951,70616,152495,1668256,1134829,2339785,16184873,11941794,21214584,1.01185270753,0.874892887202,1.2530286989
2020-05-22,1244,99163,,,,,,,107752,71114,153633,1654011,1120075,2326092,16292625,12012908,21368217,1.02537295034,0.875711197573,1.25730485224
2020-05-23,1109,100272,,,,,,,108865,71802,155089,1643168,1108214,2316283,16401490,12084710,21523306,1.03889171084,0.875823836976,1.26776463535
2020-05-24,622,100894,,,,,,,110300,72737,156852,1635916,1099319,2310595,16511790,12157447,21680158,1.05215785446,0.876028602556,1.27264399131
2020-05-25,548,101442,,,,,,,112067,73981,158916,1632441,1093450,2309146,16623857,12231428,21839074,1.06500045245,0.876685812281,1.28299707324
2020-05-26,662,102104,,,,,,,114184,75422,161464,1632936,1090715,2312174,16738041,12306850,22000538,1.07734509751,0.878344945944,1.29733119826
2020-05-27,1518,103622,,,,,,,116663,77268,164272,1637594,1091392,2319837,16854704,12384118,22164810,1.08919173601,0.879198229855,1.30563131621
2020-05-28,1178,104800,,,,,,,119510,79417,167946,1646597,1095617,2332737,16974214,12463535,22332756,1.10057164367,0.88157893861,1.31184413103
2020-05-29,1160,105960,,,,,,,122738,81942,171999,1660126,1103598,2351055,17096952,12545477,22504755,1.11152068074,0.883468262643,1.31589308169
2020-05-30,963,106923,,,,,,,126364,84763,176235,1678362,1115373,2374781,17223316,12630240,22680990,1.12209450788,0.88670814665,1.3179654126
2020-05-31,581,107504,,,,,,,130405,87966,181130,1701491,1131235,2404241,17353721,12718206,22862120,1.13233127131,0.891470186284,1.33077510702
2020-06-01,776,108280,,,,,,,134885,91554,186774,1729705,1151396,2439831,17488606,12809760,23048894,1.14226450864,0.89813274036,1.34005931327
2020-06-02,1068,109348,,,,,,,139820,95273,192846,1763202,1175805,2481615,17628426,12905033,23241740,1.15186363584,0.907459313605,1.34649160613
2020-06-03,1007,110355,,,,,,,145230,99442,199477,1802185,1204694,2529861,17773656,13004475,23441217,1.16104728622,0.920164089189,1.35163298986
2020-06-04,1023,111378,,,,,,,151138,103849,207137,1846870,1238090,2585163,17924794,13108324,23648354,1.16967234549,0.930723118645,1.35455828109
2020-06-05,914,112292,,,,,,,157562,108947,215167,1897481,1276444,2647738,18082356,13217271,23863521,1.17760886274,0.936929886534,1.35497398594
2020-06-06,659,112951,,,,,,,164522,114327,223948,1954251,1319678,2717967,18246878,13331598,24087469,1.18475895546,0.942301199792,1.35444301743
2020-06-07,438,113389,,,,,,,172038,119993,233734,2017424,1367885,2796514,18418916,13451591,24321203,1.19103255105,0.950020404351,1.35347211727
2020-06-08,519,113908,,,,,,,180125,125926,243771,2087249,1421078,2883328,18599041,13577517,24564974,1.19639897483,0.959033494446,1.35405660525
2020-06-09,950,114858,,,,,,,188796,132664,255055,2163979,1479758,2979366,18787837,13710181,24820029,1.20081413226,0.972019056321,1.35345590705
2020-06-10,901,115759,,,,,,,198055,139817,267010,2247849,1544154,3084833,18985892,13849998,25087039,1.2042806818,0.986821886752,1.35388669102
2020-06-11,871,116630,,,,,,,207901,147684,279308,2339088,1614563,3199838,19193793,13997682,25366347,1.20681647859,1.00993119152,1.35414723995
2020-06-12,828,117458,,,,,,,218323,155620,292454,2437902,1690765,3324337,19412116,14153302,25658801,1.20843017288,1.03972435306,1.3550198173
2020-06-13,759,118217,,,,,,,229301,164122,307034,2544464,1772939,3459367,19641417,14317424,25965835,1.20914832553,1.05750806469,1.35589889136
2020-06-14,308,118525,,,,,,,240799,172665,321668,2658900,1860835,3604800,19882216,14490089,26287503,1.20895118669,1.05394572152,1.35540762903
2020-06-15,394,118919,,,,,,,252766,182237,335666,2781261,1955079,3759383,20134982,14672326,26623169,1.20785873441,1.04847999567,1.35636353963
2020-06-16,838,119757,,,,,,,265139,192029,350969,2911514,2055528,3923643,20400121,14864355,26974138,1.20585285999,1.03556140498,1.3561295539
2020-06-17,744,120501,,,,,,,277833,202087,366575,3049528,2162329,4097472,20677954,15066442,27340713,1.20293662291,1.02510104024,1.35727621043
2020-06-18,718,121219,,,,,,,290752,212289,382048,3195050,2275171,4280139,20968706,15278731,27722761,1.1991142298,1.01013748286,1.35815144581
2020-06-19,670,121889,,,,,,,303782,222577,397086,3347694,2393881,4470136,21272488,15501308,28119847,1.19437112023,1.00145812654,1.35803484075
2020-06-20,604,122493,,,,,,,316799,233330,412451,3506931,2518245,4667432,21589287,15734638,28532298,1.18872096373,0.992567366517,1.35671504257
2020-06-21,285,122778,,,,,,,329669,244415,428117,3672078,2648307,4871596,21918956,15979053,28960415,1.18216800909,0.988008929638,1.35665052021
2020-06-22,389,123167,,,,,,,342258,254967,442942,3842298,2783260,5080758,22261214,16234020,29403357,1.17480777375,0.98044870491,1.35694545745
2020-06-23,847,124014,,,,,,,354433,265981,456677,4016606,2923292,5293600,22615647,16500001,29860034,1.16675959595,0.973100251336,1.3555117781
2020-06-24,759,124773,,,,,,,366074,276669,469439,4193884,3067285,5507921,22981721,16776670,30329473,1.15816396927,0.964414662957,1.35396631041
2020-06-25,551,125324,,,,,,,377076,286945,481401,4372905,3214448,5722290,23358797,17063615,30810874,1.14916890655,0.960250653616,1.35294680918
2020-06-26,617,125941,,,,,,,387352,295481,493416,4552356,3362291,5936412,23746149,17359096,31304290,1.13988991874,0.953655003627,1.35119562698
2020-06-27,504,126445,,,,,,,396837,303985,503965,4730869,3510698,6147952,24142986,17663081,31808255,1.13045084746,0.945038625282,1.35090528649
2020-06-28,273,126718,,,,,,,405485,311544,513699,4907054,3658172,6354663,24548471,17974625,32321954,1.12094528935,0.940704685402,1.35021799146
2020-06-29,377,127095,,,,,,,413271,318523,522213,5079526,3804080,6555289,24961742,18293148,32844167,1.11145622954,0.933369359839,1.34657016537
2020-06-30,625,127720,,,,,,,420186,324877,529760,5246946,3946753,6749470,25381928,18618025,33373927,1.10203941218,0.92789514542,1.34396787993
2020-07-01,694,128414,,,,,,,426240,330632,535484,5408047,4085397,6934085,25808168,18948657,33909411,1.09270962444,0.925713006087,1.34171059159
2020-07-02,727,129141,,,,,,,431451,336077,542118,5561665,4219436,7109719,26239619,19284734,34451529,1.08346448104,0.922050184335,1.33352031577
2020-07-03,660,129801,,,,,,,435850,340300,546865,5706763,4347459,7274594,26675469,19625034,34998394,1.07428177133,0.917664678687,1.32291600031
2020-07-04,265,130066,,,,,,,439471,343557,549916,5842452,4468422,7427446,27114940,19968591,35548310,1.06516169399,0.91372508697,1.31384574871
2020-07-05,288,130354,,,,,,,442353,346944,553128,5968007,4581995,7568100,27557293,20315535,36101438,1.05613604821,0.911398300955,1.30917878655
2020-07-06,355,130709,,,,,,,444539,348512,556162,6082877,4686042,7696146,28001832,20664047,36657600,1.04727076024,0.908331918912,1.30119757703
2020-07-07,1222,131931,,,,,,,446072,349774,558420,6186691,4780773,7811615,28447904,21013821,37216020,1.03865121257,0.905036849509,1.28979149121
2020-07-08,863,132794,,,,,,,446997,350958,558884,6279255,4865689,7913812,28894901,21364779,37774904,1.03036593241,0.903226567396,1.27976782583
2020-07-09,1003,133797,,,,,,,447355,351361,558465,6360536,4940354,8002826,29342256,21716140,38333369,1.02249161086,0.901911275925,1.27246627366
2020-07-10,824,134621,,,,,,,447188,351526,558990,6430648,5004926,8080412,29789444,22067666,38892359,1.01508512186,0.898591392123,1.26274057105
2020-07-11,690,135311,,,,,,,446533,350752,559298,6489830,5060175,8146312,30235977,22418418,39451657,1.00818714696,0.897867367902,1.25227950232
2020-07-12,459,135770,,,,,,,445427,349880,558943,6538420,5106042,8201315,30681404,22768298,40010600,1.00182235616,0.897319416701,1.23928884592
2020-07-13,367,136137,,,,,,,443903,348591,558512,6576838,5143052,8246150,31125307,23116889,40569112,0.995996369185,0.894657196896,1.22413821079
2020-07-14,926,137063,,,,,,,441992,346832,556501,6605559,5171334,8280460,31567299,23463721,41125613,0.990694473522,0.893186444652,1.20672420057
2020-07-15,968,138031,,,,,,,439726,344386,554505,6625099,5190807,8305240,32007025,23808107,41680118,0.985886724772,0.892150194713,1.18650599659
2020-07-16,943,138974,,,,,,,437135,341856,552021,6635994,5201990,8321790,32444160,24149963,42232139,0.981537476062,0.890930528176,1.17306137823
2020-07-17,930,139904,,,,,,,434246,338631,549283,6638789,5204518,8328988,32878406,24488594,42781422,0.977613029537,0.887821840263,1.15670195595
2020-07-18,868,140772,,,,,,,431087,335376,546349,6634026,5199559,8328515,33309493,24823970,43327771,0.974083608922,0.885506513752,1.13825076408
2020-07-19,447,141219,,,,,,,427683,331500,543778,6622238,5187469,8322422,33737176,25155470,43871549,0.970921234192,0.884254434376,1.12558132485
2020-07-20,514,141733,,,,,,,424058,327183,540912,6603942,5167658,8310245,34161234,25482653,44412461,0.968097277746,0.882727778531,1.10345263413
2020-07-21,1107,142840,,,,,,,420234,322819,537380,6579637,5141917,8291497,34581468,25805472,44949841,0.965581665497,0.880768722306,1.08314359433
2020-07-22,1216,144056,,,,,,,416230,318788,533047,6549795,5110886,8266150,34997698,26124260,45482888,0.963343351977,0.879207011962,1.0677612328
2020-07-23,1094,145150,,,,,,,412067,314550,529621,6514865,5074448,8236905,35409765,26438810,46012509,0.961351162163,0.877308975089,1.05039260976
2020-07-24,1132,146282,,,,,,,407763,310525,526135,6475273,5033594,8204574,35817528,26749335,46538644,0.959574675851,0.876631853238,1.0414652253
2020-07-25,899,147181,,,,,,,403333,305956,523264,6431419,4988008,8168846,36220861,27055291,47061908,0.957985200858,0.876030077011,1.03855378221
2020-07-26,472,147653,,,,,,,398795,301090,519574,6383680,4938323,8129120,36619656,27356381,47581482,0.956556774367,0.875258500664,1.03793204708
2020-07-27,1120,148773,,,,,,,394164,296440,515005,6332417,4884860,8085179,37013820,27652821,48096487,0.955266942721,0.874609182721,1.03561308792
2020-07-28,1374,150147,,,,,,,389452,291814,511014,6277966,4828058,8037688,37403272,27944635,48607501,0.954097060396,0.873944651509,1.03200914661
2020-07-29,1432,151579,,,,,,,384674,287293,507233,6220648,4768484,7988430,37787946,28231928,49114734,0.95303200826,0.873482194101,1.02913631202
2020-07-30,1209,152788,,,,,,,379841,282528,502692,6160762,4706595,7936613,38167787,28514456,49617426,0.952059449232,0.873039559775,1.02810537523
2020-07-31,1243,154031,,,,,,,374963,277376,498276,6098591,4642098,7882873,38542750,28791832,50115702,0.95116890093,0.872614058869,1.02630447398
2020-08-01,1115,155146,,,,,,,370051,272172,493643,6034395,4575627,7827261,38912801,29064004,50609345,0.950350929054,0.872203713399,1.02540165965
2020-08-02,403,155549,,,,,,,365112,267097,489418,5968420,4507337,7770343,39277913,29331101,51098763,0.949596652352,0.871807048492,1.02402723084
2020-08-03,530,156079,,,,,,,360156,262089,485219,5900893,4437917,7711786,39638069,29593190,51583982,0.948897582951,0.871422945962,1.02325202757
2020-08-04,1378,157457,,,,,,,355188,256934,480830,5832023,4367656,7651693,39993257,29850124,52064812,0.948245701506,0.871050541393,1.02266968087
2020-08-05,1376,158833,,,,,,,350216,252018,476020,5762005,4296846,7590330,40343473,30102142,52540832,0.947633628467,0.870689151628,1.022085376
2020-08-06,1253,160086,,,,,,,345245,247019,471329,5691019,4225071,7528596,40688718,30349161,53012161,0.9470547821,0.870338223547,1.02149894655
2020-08-07,1242,161328,,,,,,,340281,241996,466561,5619233,4152514,7465518,41028999,30591157,53478722,0.946503467807,0.869997297813,1.02110696841
2020-08-08,1077,162405,,,,,,,335328,237168,461730,5546798,4079157,7401098,41364327,30828325,53940452,0.945974888914,0.869665983193,1.02049191328
2020-08-09,511,162916,,,,,,,330391,232339,457239,5473856,4005542,7335057,41694718,31060664,54397691,0.945465094731,0.869343938346,1.0199860844
2020-08-10,527,163443,,,,,,,325474,227749,453099,5400535,3932203,7268565,42020192,31288413,54850790,0.944970889799,0.869030858872,1.01947817065
2020-08-11,1064,164507,,,,,,,320581,223053,448633,5326952,3858819,7202180,42340773,31511466,55299423,0.944489726115,0.868726468066,1.01896818281
2020-08-12,1505,166012,,,,,,,315713,218483,444159,5253214,3785492,7135309,42656486,31729949,55743582,0.944019594074,0.868430510295,1.01845614037
2020-08-13,1070,167082,,,,,,,310875,214105,439684,5179415,3712307,7067748,42967361,31944054,56183266,0.943558921587,0.868142746248,1.01749535194
2020-08-14,1338,168420,,,,,,,306070,209636,435636,5105644,3639412,7000676,43273431,32153690,56618902,0.943106485987,0.867862949522,1.01686133924
2020-08-15,1034,169454,,,,,,,301300,205333,431260,5031980,3567367,6933652,43574731,32359023,57050162,0.942661340011,0.867590904154,1.01622493688
2020-08-16,571,170025,,,,,,,296568,200964,426771,4958497,3496156,6866786,43871299,32559987,57476933,0.942222751309,0.867326402842,1.0155862042
2020-08-17,446,170471,,,,,,,291877,196634,422005,4885262,3425689,6799399,44163176,32756621,57898938,0.941790153975,0.86706922386,1.01484759805
2020-08-18,1325,171796,,,,,,,287230,192213,417323,4812336,3355806,6731531,44450406,32948834,58316261,0.941363110273,0.8668197948,1.01422830651
2020-08-19,1353,173149,,,,,,,282629,188203,413018,4739777,3287067,6663760,44733035,33137037,58729279,0.940941280726,0.866577639231,1.01373569547
2020-08-20,1079,174228,,,,,,,278075,183948,408667,4667636,3218988,6596453,45011110,33320985,59137946,0.940524400949,0.866314189599,1.01324123847
2020-08-21,1105,175333,,,,,,,273572,179687,403922,4595963,3151649,6529090,45284682,33500672,59541868,0.94011226379,0.866010681716,1.0125892277
2020-08-22,982,176315,,,,,,,269119,175619,399501,4524802,3085268,6462078,45553801,33676291,59941369,0.939704705635,0.865716570701,1.01193557175
2020-08-23,450,176765,,,,,,,264719,171783,394846,4454192,3019882,6395244,45818520,33848074,60336215,0.939301595941,0.865431394578,1.01124856055
2020-08-24,442,177207,,,,,,,260631,167889,390802,4384432,2955430,6328854,46079151,34015963,60727017,0.939812150819,0.867680507734,1.01085682454
2020-08-25,1239,178446,,,,,,,256590,164027,386536,4315547,2891709,6262331,46335741,34179990,61113553,0.940329706455,0.869766873475,1.01051823656
2020-08-26,1225,179671,,,,,,,252608,160473,382460,4247574,2829129,6196196,46588349,34340463,61496013,0.940853820644,0.871699587437,1.0102387409
2020-08-27,1111,180782,,,,,,,248697,157009,378493,4180558,2767654,6130560,46837046,34497472,61874506,0.941384449799,0.872930285423,1.01227124231
2020-08-28,971,181753,,,,,,,244884,153603,374549,4114566,2707151,6065446,47081930,34651075,62249055,0.941921539992,0.87326278799,1.01371073077
2020-08-29,958,182711,,,,,,,241193,150515,370497,4049689,2648027,6000327,47323123,34801590,62619552,0.942465024445,0.872969603741,1.01598511568
2020-08-30,310,183021,,,,,,,237604,147421,366422,3985994,2590111,5935504,47560727,34949011,62985974,0.9430148018,0.871591777378,1.0181623018
2020-08-31,573,183594,,,,,,,234100,144198,362968,3923526,2533341,5871714,47794827,35093209,63348942,0.943570732459,0.871306849513,1.02009307686
2020-09-01,1067,184661,,,,,,,230682,141228,359680,3862331,2477931,5809401,48025509,35234437,63708622,0.944132709476,0.871331979099,1.02273750737
2020-09-02,,,836.292253649,605,1138,185497.292254,185266,185799,227350,138361,356573,3802451,2424076,5748654,48252859,35372798,64065195,0.944700650754,0.871339163705,1.02424879346
2020-09-03,,,825.308121708,594,1129,186322.600375,185860,186928,224112,135365,353294,3743935,2371234,5688930,48476971,35508163,64418489,0.945274474829,0.871463058796,1.02587708974
2020-09-04,,,814.256681769,582,1120,187136.857057,186443,188048,220967,132649,350148,3686826,2319929,5630410,48697938,35640812,64768637,0.945854098787,0.870781082035,1.0289276326
2020-09-05,,,803.155872898,571,1110,187940.01293,187014,189157,217911,129668,347339,3631166,2269909,5573822,48915849,35770480,65115976,0.946439424829,0.869645986399,1.03051192623
2020-09-06,,,792.022382725,560,1100,188732.035313,187574,190256,214941,127171,344414,3576988,2221461,5518728,49130790,35897651,65460390,0.947030355129,0.869893182288,1.03243385652
2020-09-07,,,780.871724374,548,1089,189512.907037,188123,191344,212056,124711,341203,3524326,2174389,5465072,49342846,36022362,65801593,0.947626797214,0.869068908554,1.03410174539
2020-09-08,,,769.718281303,537,1078,190282.625318,188661,192422,209258,122240,338034,3472952,2128740,5412290,49552104,36144602,66139627,0.94822866153,0.868331917458,1.03542867502
2020-09-09,,,758.577948857,526,1068,191041.203267,189188,193490,206545,119844,335817,3422908,2084560,5361551,49758649,36264446,66475444,0.948835858118,0.868574904002,1.03716462753
2020-09-10,,,747.467600765,516,1058,191788.670868,189704,194547,203917,117463,333960,3374218,2041554,5313027,49962566,36381909,66809404,0.949448292857,0.86838973229,1.04028652106
2020-09-11,,,736.404781192,506,1049,192525.075649,190210,195596,201374,115218,331535,3326894,1999766,5266049,50163940,36497127,67140939,0.950065868636,0.86758022545,1.04393211673
2020-09-12,,,725.407595568,495,1040,193250.483245,190706,196635,198913,113054,328806,3280923,1959219,5220289,50362853,36610181,67469745,0.950688487672,0.868206312469,1.0469180598
2020-09-13,,,714.492315178,485,1031,193964.97556,191192,197665,196534,111059,326729,3236264,1919764,5176506,50559387,36721240,67796474,0.95131605183,0.867928060072,1.04907216485
2020-09-14,,,703.671791308,475,1020,194668.647351,191667,198684,194238,108865,324582,3192899,1881209,5134650,50753625,36830105,68121056,0.951948461977,0.866298566452,1.05178799433
2020-09-15,,,692.959057204,466,1010,195361.606408,192134,199693,192023,106823,322789,3150822,1843837,5094463,50945648,36936928,68443845,0.952585616706,0.86391894963,1.05453612203
2020-09-16,,,682.367186926,456,999,196043.973595,192591,200691,189890,104808,320749,3110029,1807420,5055530,51135538,37041736,68764594,0.953227411957,0.861720022323,1.05690793432
2020-09-17,,,671.90894147,447,988,196715.882537,193038,201678,187837,102907,318753,3070517,1771969,5017702,51323375,37144643,69083347,0.953873741371,0.860934359622,1.05944955769
2020-09-18,,,661.59612462,437,979,197377.478662,193475,202656,185865,100987,316895,3032270,1737593,4981281,51509240,37245630,69400242,0.954524496528,0.861038347094,1.06173436187
2020-09-19,,,651.43685503,428,969,198028.915517,193904,203624,183972,99221,314939,2995275,1704165,4946046,51693212,37344851,69715181,0.955179566844,0.860256429627,1.06388434788
2020-09-20,,,641.439184156,419,958,198670.354701,194323,204581,182159,97426,314045,2959522,1671924,4912728,51875371,37442277,70029226,0.955838839161,0.858647527765,1.06701807336
2020-09-21,,,631.611159652,410,949,199301.96586,194734,205529,180425,95672,313432,2925006,1640423,4881727,52055796,37537949,70342658,0.956502197389,0.857558258044,1.069660672
2020-09-22,,,621.960701681,401,939,199923.926562,195135,206468,178771,94026,313359,2891721,1609734,4853868,52234567,37631975,70656017,0.957169522379,0.855562081071,1.07285317536
2020-09-23,,,612.495238368,392,930,200536.4218,195528,207396,177196,92359,313292,2859658,1579851,4829123,52411763,37724334,70969309,0.957840691863,0.853387057205,1.07599739469
2020-09-24,,,603.216201421,383,920,201139.638002,195912,208316,175699,90736,313602,2828813,1550740,4806912,52587462,37815070,71282911,0.958515580338,0.852003218689,1.07834653785
2020-09-25,,,594.125667896,375,910,201733.76367,196287,209225,174281,89185,313746,2799177,1522460,4786709,52761743,37904255,71596657,0.959194058842,0.850679010586,1.08008506223
2020-09-26,,,585.226175542,367,901,202318.989845,196655,210125,172943,87696,314399,2770746,1494936,4769591,52934686,37991951,71911056,0.959875994694,0.848988324251,1.08271876383
2020-09-27,,,576.520405927,360,892,202895.510251,197016,211015,171683,86211,315197,2743516,1468090,4756003,53106369,38078162,72226253,0.960561251255,0.847221502728,1.08596134645
2020-09-28,,,568.010625762,352,883,203463.520877,197369,211898,170503,84732,316168,2717485,1441760,4745455,53276872,38162894,72542421,0.961249687725,0.845412128119,1.08920153388
2020-09-29,,,559.698062412,345,874,204023.218939,197714,212771,169402,83358,317155,2692649,1416250,4738027,53446274,38246252,72859576,0.961941158939,0.843610272183,1.09243860136
2020-09-30,,,551.583491322,338,865,204574.802431,198052,213635,168381,81921,318752,2669006,1391347,4733985,53614655,38328173,73178328,0.962635515126,0.841815826949,1.09658341385
2020-10-01,,,543.667666213,330,859,205118.470097,198383,214493,167440,80412,319955,2646557,1366949,4733185,53782095,38408585,73498283,0.963338041663,0.840028684698,1.10058100535
2020-10-02,,,535.95135426,323,851,205654.421451,198707,215343,166580,79122,321318,2625300,1343165,4735743,53948675,38487707,73819601,0.964045854373,0.838312597868,1.10296862965
2020-10-03,,,528.435315182,317,844,206182.856766,199025,216186,165802,77808,323863,2605237,1319986,4742703,54114477,38565515,74143464,0.964756226439,0.83653601081,1.1053439231
2020-10-04,,,521.119984015,310,836,206703.97675,199335,217021,165105,76719,326312,2586370,1297484,4754062,54279582,38642234,74469776,0.9654724451,0.834766421092,1.10958281006
2020-10-05,,,514.005527714,304,829,207217.982278,199640,217849,164491,75539,328784,2568702,1275597,4768788,54444073,38717773,74798560,0.966196728197,0.833003723293,1.11297923422
2020-10-06,,,507.091978267,298,822,207725.074256,199939,218670,163960,74418,331289,2552237,1254343,4786632,54608033,38792191,75129849,0.966924657752,0.831247812808,1.11637234999
2020-10-07,,,500.379316463,291,816,208225.453573,200231,219484,163514,73259,333900,2536980,1233577,4807161,54771547,38865450,75463749,0.967654210328,0.829572155537,1.11976135258
2020-10-08,,,493.86749094,286,810,208719.321064,200517,220294,163154,72092,337447,2522938,1213310,4831313,54934701,38937542,75801196,0.968385785195,0.827875021031,1.12314539343
2020-10-09,,,487.556255651,280,805,209206.877319,200799,221097,162879,70728,341408,2510119,1193303,4859124,55097580,39008270,76142604,0.969125878971,0.826119324378,1.12654388265
2020-10-10,,,481.445166136,275,798,209688.322486,201074,221894,162693,69665,345191,2498530,1173784,4890564,55260273,39077935,76487795,0.969875387423,0.824683574428,1.13008109512
2020-10-11,,,475.533613723,269,793,210163.856099,201344,222686,162595,68594,349017,2488182,1154683,4925178,55422868,39146529,76836812,0.970628637346,0.823127111467,1.13361323144
2020-10-12,,,469.820859399,264,787,210633.676959,201610,223472,162588,67599,353200,2479087,1136071,4963180,55585456,39214128,77190012,0.971382679696,0.822679629371,1.13733721355
2020-10-13,,,464.306163653,259,782,211097.983122,201870,224253,162672,66560,358239,2471256,1117899,5005248,55748128,39280688,77548251,0.972145073219,0.821819496524,1.14161727357
2020-10-14,,,458.988874858,254,777,211556.971997,202125,225029,162850,65562,363898,2464704,1100103,5051984,55910978,39346250,77912149,0.972913657259,0.821741728441,1.14568055058
2020-10-15,,,453.868288508,250,773,212010.840286,202376,225801,163123,64588,369159,2459446,1082771,5102389,56074101,39410838,78281308,0.973703584849,0.821685304188,1.14882491359
2020-10-16,,,448.943661249,245,770,212459.783947,202622,226569,163493,63616,374260,2455499,1065976,5156698,56237594,39474454,78655568,0.974497946762,0.820888646365,1.15133620915
2020-10-17,,,444.21424547,241,765,212903.998192,202863,227333,163962,62713,380852,2452882,1049567,5216228,56401556,39537167,79036420,0.975291964369,0.819868563984,1.15536178285
2020-10-18,,,439.67933766,236,762,213343.67753,203101,228093,164533,61704,387458,2451613,1033465,5279825,56566089,39598871,79423878,0.976085631291,0.819532247702,1.15909315034
2020-10-19,,,435.338423031,232,760,213779.015953,203333,228851,165206,60845,394677,2451714,1017589,5348196,56731295,39659716,79818555,0.976881996471,0.818329386786,1.16292963633
2020-10-20,,,431.191044816,228,758,214210.206998,203562,229608,165986,60035,401693,2453209,1002083,5421118,56897281,39719751,80220248,0.977682312717,0.817178967021,1.16599383509
2020-10-21,,,427.236807769,224,757,214637.443806,203786,230362,166874,59289,409825,2456122,986952,5499665,57064155,39779040,80630073,0.97848552884,0.817975780801,1.16919725381
2020-10-22,,,423.475391938,219,757,215060.919198,204007,231118,167872,58589,418962,2460480,972277,5584744,57232027,39837629,81049035,0.979304994598,0.817624220709,1.17225051648
2020-10-23,,,419.906583107,216,758,215480.825781,204224,231874,168985,57849,427884,2466312,958030,5675192,57401012,39895478,81476919,0.980124912272,0.816948220422,1.17655276141
2020-10-24,,,416.530534923,212,759,215897.356316,204437,232630,170215,57093,436500,2473647,944393,5770289,57571227,39952571,81913419,0.980944396437,0.817223773331,1.17884528998
2020-10-25,,,413.347514476,209,761,216310.70383,204647,233388,171564,56359,445025,2482518,931087,5870115,57742791,40008930,82358444,0.981763335481,0.816915863732,1.18218433431
2020-10-26,,,410.357912326,205,764,216721.061742,204853,234149,173037,55672,454604,2492960,918165,5975696,57915828,40064602,82813048,0.982584128484,0.816811574981,1.18558665503
2020-10-27,,,407.562258515,202,766,217128.624001,205056,234913,174636,54969,464737,2505008,905538,6087221,58090464,40119571,83277785,0.983400709784,0.816588647848,1.18896261855
2020-10-28,,,404.96125735,198,768,217533.585258,205255,235678,176366,54336,475849,2518702,893315,6204822,58266830,40173907,83753634,0.984214585955,0.815969660154,1.19198977193
2020-10-29,,,402.555825865,195,771,217936.141084,205451,236446,178229,53775,487165,2534081,881530,6328087,58445059,40227682,84240799,0.985028517257,0.815048096785,1.19553203964
2020-10-30,,,400.347081298,191,773,218336.488165,205644,237216,180231,53202,500192,2551189,870147,6459122,58625290,40280884,84740991,0.985843638939,0.813910812911,1.19933654068
2020-10-31,,,398.336330468,188,778,218734.824496,205833,237991,182375,52629,512761,2570070,859163,6597628,58807665,40333513,85253752,0.986654146612,0.812708450361,1.20281735128
2020-11-01,,,396.525068615,185,783,219131.349565,206019,238771,184664,52056,525980,2590772,848509,6742763,58992329,40385569,85779732,0.987459547173,0.811907930615,1.20636277938
