date,actual_deaths,total_deaths,predicted_deaths_mean,predicted_deaths_lower,predicted_deaths_upper,predicted_total_deaths_mean,predicted_total_deaths_lower,predicted_total_deaths_upper,predicted_new_infected_mean,predicted_new_infected_lower,predicted_new_infected_upper,predicted_current_infected_mean,predicted_current_infected_lower,predicted_current_infected_upper,predicted_total_infected_mean,predicted_total_infected_lower,predicted_total_infected_upper,r_values_mean,r_values_lower,r_values_upper
2020-02-05,0,0,,,,,,,125,65,178,125,65,178,125,65,178,2.26251766252,2.1,2.4
2020-02-06,0,0,,,,,,,125,65,178,250,130,356,250,130,356,2.26250823079,2.09999084612,2.39999969155
2020-02-07,0,0,,,,,,,125,65,178,376,194,534,375,195,534,2.26250503895,2.09998778947,2.39999951502
2020-02-08,0,0,,,,,,,125,65,178,501,260,712,500,260,712,2.26250075438,2.09998371155,2.39999927974
2020-02-09,0,0,,,,,,,287,163,404,788,438,1103,787,423,1116,2.26249499799,2.09997827097,2.39999890218
2020-02-10,0,0,,,,,,,287,163,404,1075,607,1502,1074,586,1520,2.26248725717,2.09997101213,2.39999832507
2020-02-11,0,0,,,,,,,287,163,404,1362,773,1904,1361,749,1924,2.26247683793,2.09996132706,2.39999743352
2020-02-12,0,0,,,,,,,287,163,404,1649,938,2306,1648,912,2328,2.2624627996,2.09994840438,2.39999610614
2020-02-13,0,0,,,,,,,466,280,650,2116,1238,2936,2114,1192,2978,2.26244386555,2.09993116128,2.39999414816
2020-02-14,0,0,,,,,,,674,411,937,2790,1655,3867,2788,1603,3915,2.26238847623,2.09987844877,2.39996709005
2020-02-15,0,0,,,,,,,1216,751,1630,4006,2463,5459,4004,2354,5545,2.26235019259,2.09984400241,2.39995974814
2020-02-16,0,0,,,,,,,2410,1476,3100,6415,4068,8498,6414,3830,8645,2.26229127066,2.09979179856,2.39994309864
2020-02-17,0,0,,,,,,,3898,2538,4932,10313,6739,13343,10312,6368,13577,2.26221579257,2.0997264297,2.39992333586
2020-02-18,0,0,,,,,,,4314,2854,5469,14627,9635,18786,14626,9222,19046,2.26211680474,2.09964240376,2.39989805798
2020-02-19,0,0,,,,,,,5071,3414,6418,19698,13114,25162,19697,12636,25464,2.26198514782,2.09953300894,2.3998641397
2020-02-20,0,0,,,,,,,5210,3522,6612,24783,16583,31588,24907,16158,32076,2.26180756248,2.09938869877,2.39981639842
2020-02-21,0,0,,,,,,,5740,3941,7271,30398,20483,38660,30647,20099,39347,2.26156639315,2.09919716162,2.39974781552
2020-02-22,0,0,,,,,,,6827,4759,8655,37100,25224,47099,37474,24858,48002,2.2612414813,2.09894087615,2.39965118398
2020-02-23,0,0,,,,,,,8170,5774,10335,45144,31028,57181,45644,30632,58337,2.26080376675,2.09860286146,2.39951005987
2020-02-24,0,0,,,,,,,10381,7314,13216,55238,38259,69934,56025,37946,71553,2.26021161372,2.09815589959,2.39931819803
2020-02-25,0,0,,,,,,,16263,10904,20682,71214,49175,90094,72288,48850,92235,2.25940775342,2.09756354045,2.39903915341
2020-02-26,0,0,,,,,,,19662,13409,25029,90589,62464,114681,91950,62259,117264,2.25831327732,2.09677705154,2.39861477273
2020-02-27,0,0,,,,,,,21447,14516,27496,111748,76830,141758,113397,76775,144760,2.25682129618,2.09569262574,2.39801815949
2020-02-28,0,0,,,,,,,26087,17477,33801,137368,94024,174900,139484,94252,178561,2.25478472864,2.09418554187,2.39714907422
2020-02-29,1,1,,,,,,,31903,20826,41994,168597,114448,215915,171387,115078,220555,2.25200064193,2.09214150252,2.39587476433
2020-03-01,0,1,,,,,,,41436,26492,55152,208817,140250,269326,212823,141570,275707,2.24819038415,2.0895698898,2.39400168628
2020-03-02,5,6,,,,,,,51550,32605,69233,257957,171487,335320,264373,174175,344940,2.24297347849,2.08593523005,2.39124259202
2020-03-03,1,7,,,,,,,63977,40298,86602,318037,209340,416846,328350,214473,431542,2.2358345699,2.08126080558,2.38717479847
2020-03-04,4,11,,,,,,,78516,48818,107262,392239,255400,518469,406866,263291,538804,2.2260822423,2.07419390776,2.3811789778
2020-03-05,1,12,,,,,,,98213,60508,134839,485380,312595,646705,505079,323799,673643,2.21280262537,2.06580226427,2.37241574514
2020-03-06,2,14,,,,,,,120393,73392,166242,600563,382575,806148,625472,397191,839885,2.19481572196,2.05210681424,2.35964263511
2020-03-07,3,17,,,,,,,145503,88884,201711,740325,467608,1000436,770975,486075,1041596,2.17065029456,2.03105566901,2.34180767676
2020-03-08,4,21,,,,,,,172999,106975,238601,906497,569812,1230299,943974,593050,1280197,2.1385665438,2.00137034414,2.31497866965
2020-03-09,1,22,,,,,,,202153,128401,274447,1100480,692299,1494438,1146127,721451,1554644,2.09667014987,1.94437882705,2.27827142567
2020-03-10,6,28,,,,,,,231906,153592,310911,1322004,838314,1792273,1378033,875043,1865555,2.04316644581,1.86866289378,2.24808860265
2020-03-11,5,33,,,,,,,258497,176375,345628,1564239,1003733,2117165,1636530,1051418,2211183,1.97677528394,1.78392081574,2.21025836808
2020-03-12,10,43,,,,,,,280302,193674,372972,1824879,1183854,2465122,1916832,1245092,2584155,1.89724377111,1.68815957156,2.15606100527
2020-03-13,8,51,,,,,,,297101,206504,392852,2100533,1375725,2830446,2213933,1451596,2977007,1.80577838412,1.57117177825,2.103100225
2020-03-14,7,58,,,,,,,308651,214483,404094,2383097,1572666,3200677,2522584,1666079,3381101,1.70516733533,1.45615639609,2.04421763011
2020-03-15,12,70,,,,,,,316299,220952,414425,2667493,1772876,3572955,2838883,1887031,3795526,1.59947345904,1.32932575389,1.97755787053
2020-03-16,27,97,,,,,,,320503,226901,424480,2946561,1973547,3942106,3159386,2113932,4220006,1.49339059738,1.21856904413,1.89213546185
2020-03-17,35,132,,,,,,,322177,231283,429107,3217188,2172647,4301780,3481563,2345215,4649113,1.3914977745,1.12442935682,1.78461766456
2020-03-18,59,191,,,,,,,322192,234514,429533,3475403,2367521,4644439,3803755,2579729,5078646,1.29763198045,1.05210900971,1.66726788511
2020-03-19,73,264,,,,,,,321078,237347,426712,3717965,2556965,4963458,4124833,2817076,5505358,1.21449516187,1.00003741767,1.54468744426
2020-03-20,99,363,,,,,,,319309,239690,424326,3939061,2737324,5252331,4444142,3056766,5929684,1.14351100032,0.964033381253,1.43547401697
2020-03-21,99,462,,,,,,,317005,241175,421852,4135673,2906516,5507280,4761147,3297941,6351536,1.08489742729,0.938391237651,1.33618965558
2020-03-22,110,572,,,,,,,314266,241735,417225,4304436,3060927,5722071,5075413,3539676,6768761,1.03790424543,0.922109356744,1.25257030951
2020-03-23,189,761,,,,,,,311233,241989,411308,4442671,3197597,5894023,5386646,3781665,7180069,1.00114761048,0.901275194482,1.17549290687
2020-03-24,239,1000,,,,,,,307950,241749,403505,4548468,3312675,6022193,5694596,4023414,7583574,0.972954725641,0.882349296459,1.11239440153
2020-03-25,324,1324,,,,,,,304455,241000,396088,4621018,3401781,6106296,5999051,4264414,7979662,0.951641564169,0.869417868445,1.06024121685
2020-03-26,408,1732,,,,,,,300744,238903,389611,4663264,3465801,6149357,6299795,4503317,8369273,0.935687620326,0.860177739155,1.02233974013
2020-03-27,518,2250,,,,,,,296800,234829,382094,4679761,3507620,6157601,6596595,4738146,8751367,0.923814907129,0.853637220175,0.994350939816
2020-03-28,633,2883,,,,,,,292629,230672,374651,4675289,3531661,6138596,6889224,4968818,9126018,0.91500034032,0.849236798394,0.97861250452
2020-03-29,586,3469,,,,,,,288266,226276,367304,4654904,3542595,6101072,7177490,5195094,9493322,0.90845182969,0.845700362365,0.967349041121
2020-03-30,692,4161,,,,,,,283663,222145,360089,4622268,3542342,6046339,7461153,5417239,9853411,0.903570039341,0.843306325346,0.959409015296
2020-03-31,1085,5246,,,,,,,278868,217611,352389,4580633,3531235,5974375,7740021,5634850,10205800,0.899908528723,0.841938272824,0.954238021208
2020-04-01,1172,6418,,,,,,,273896,213265,345209,4532352,3511234,5891017,8013917,5848115,10551009,0.897138240826,0.840900467631,0.950581301866
2020-04-02,1503,7921,,,,,,,268773,208650,337943,4478933,3483544,5800300,8282690,6056765,10888952,0.895018320372,0.839671803689,0.947898196433
2020-04-03,1392,9313,,,,,,,263525,204197,331522,4421380,3448752,5706078,8546215,6260962,11220474,0.893373246155,0.838630084043,0.945622135264
2020-04-04,1523,10836,,,,,,,258176,199911,324587,4360246,3407578,5607373,8804391,6460873,11545061,0.892075437168,0.837960669849,0.943870569281
2020-04-05,1590,12426,,,,,,,252757,195570,318152,4295999,3360956,5504892,9057148,6656443,11863213,0.891032274936,0.837316661047,0.942418194168
2020-04-06,1770,14196,,,,,,,247303,191140,311579,4229036,3309714,5400523,9304451,6847583,12174792,0.89017654221,0.836518756236,0.941280890391
2020-04-07,2571,16767,,,,,,,241845,186759,304812,4159648,3254125,5295220,9546296,7034342,12479604,0.889459436161,0.835871469913,0.940465418954
2020-04-08,2146,18913,,,,,,,236414,182370,298284,4088112,3194547,5190957,9782710,7216712,12777888,0.888845489423,0.835412622213,0.939792634927
2020-04-09,2228,21141,,,,,,,231036,178160,291653,4014692,3131570,5087235,10013746,7394872,13069541,0.888308889826,0.834891031136,0.939305969052
2020-04-10,2218,23359,,,,,,,225733,173961,285037,3939682,3066472,4983233,10239479,7568833,13354578,0.887830818456,0.834488847399,0.938722746682
2020-04-11,2119,25478,,,,,,,220524,169742,278668,3863406,3001253,4880216,10460003,7738575,13633246,0.887394620984,0.834160932449,0.938246311618
2020-04-12,1816,27294,,,,,,,215420,165593,272497,3786198,2936078,4778323,10675423,7904168,13905743,0.886994319345,0.833776049329,0.937853012206
2020-04-13,1946,29240,,,,,,,210430,161571,266440,3708362,2871321,4677601,10885853,8065739,14172183,0.886622590288,0.833392314608,0.937500335854
2020-04-14,2455,31695,,,,,,,205559,157595,260750,3630258,2806749,4578331,11091412,8223334,14432933,0.88627143154,0.833078447892,0.937176459585
2020-04-15,2609,34304,,,,,,,200809,153648,255220,3552200,2742790,4481170,11292221,8376982,14688153,0.885946524145,0.832786436178,0.93686962398
2020-04-16,2176,36480,,,,,,,196181,149815,249787,3474485,2679366,4385730,11488402,8526797,14937940,0.88563590384,0.83246714991,0.936571859434
2020-04-17,2093,38573,,,,,,,191671,146142,244734,3397383,2616889,4292509,11680073,8672939,15182674,0.885342349194,0.832210014966,0.936259468695
2020-04-18,1960,40533,,,,,,,187279,142533,239628,3321138,2555266,4200595,11867352,8815472,15422302,0.88506287529,0.831993183199,0.935997632299
2020-04-19,1931,42464,,,,,,,183001,138952,234831,3245963,2494345,4110841,12050353,8954424,15657133,0.884798804278,0.83176600307,0.935718436118
2020-04-20,2186,44650,,,,,,,178834,135416,230120,3172040,2434201,4022834,12229187,9089840,15887253,0.88454923307,0.831528069445,0.935447231092
2020-04-21,2548,47198,,,,,,,174775,131943,225537,3099513,2375002,3936841,12403962,9221783,16112790,0.884314878953,0.831314367829,0.935194812789
2020-04-22,2434,49632,,,,,,,170821,128674,221118,3028489,2316887,3853247,12574783,9350457,16333908,0.884097540412,0.831142567068,0.934967276923
2020-04-23,2466,52098,,,,,,,166970,125418,216957,2959045,2259904,3772042,12741753,9475875,16550865,0.883900494724,0.830917511269,0.934693561633
2020-04-24,2154,54252,,,,,,,163219,122067,212771,2891229,2203770,3693296,12904972,9597942,16763636,0.883728168638,0.830750948032,0.934439659391
2020-04-25,1698,55950,,,,,,,159569,118885,208824,2825064,2148648,3617215,13064541,9716827,16972460,0.883586534199,0.830549595078,0.934229386538
2020-04-26,1329,57279,,,,,,,156015,115673,204944,2760555,2094542,3543607,13220556,9832500,17177404,0.883484173848,0.830434698888,0.933990201779
2020-04-27,1466,58745,,,,,,,152559,112731,201119,2697694,2041647,3472329,13373115,9945231,17378523,0.883432264155,0.830340732516,0.933805190555
2020-04-28,2241,60986,,,,,,,149197,109664,197414,2636461,1989710,3403382,13522312,10054895,17575937,0.883446062982,0.830326735575,0.933725893167
2020-04-29,2521,63507,,,,,,,145932,106738,193781,2576834,1938825,3336479,13668244,10161633,17769718,0.883545939967,0.8303072397,0.9335331128
2020-04-30,2322,65829,,,,,,,142762,103906,190315,2518786,1889051,3271622,13811006,10265539,17960033,0.88375885497,0.83027455401,0.933555598882
2020-05-01,1891,67720,,,,,,,139690,101167,187061,2462296,1840378,3208927,13950696,10366706,18147094,0.884120127341,0.830221602293,0.933395168803
2020-05-02,1692,69412,,,,,,,136715,98477,183866,2407340,1792685,3148076,14087411,10465183,18330960,0.884675427067,0.830395245919,0.933524411845
2020-05-03,1120,70532,,,,,,,133840,95946,180818,2353900,1746074,3089272,14221251,10561129,18511778,0.885482655692,0.830440861911,0.933643388752
2020-05-04,1333,71865,,,,,,,131069,93475,177755,2301968,1700571,3032194,14352320,10654604,18689533,0.886613285071,0.830577415695,0.934146856025
2020-05-05,2318,74183,,,,,,,128406,91115,174888,2251540,1656242,2976956,14480726,10745719,18864421,0.888152271056,0.831028300424,0.935229899476
2020-05-06,2364,76547,,,,,,,125855,88656,172156,2202619,1612931,2923563,14606581,10834375,19036577,0.890195323709,0.831264168755,0.939894366558
2020-05-07,1934,78481,,,,,,,123422,86463,169555,2155219,1570695,2871986,14730003,10920838,19206132,0.892842225857,0.831779618473,0.953097527806
2020-05-08,1747,80228,,,,,,,121115,84383,167118,2109364,1529640,2822134,14851118,11005221,19373250,0.89618567099,0.832100951962,0.969584809144
2020-05-09,1488,81716,,,,,,,118943,82403,164831,2065088,1489961,2774181,14970061,11087624,19538081,0.900297356929,0.83231291603,0.98990920875
2020-05-10,893,82609,,,,,,,116917,80572,162545,2022436,1451636,2727889,15086978,11168196,19700626,0.905216518601,0.832857736382,1.01623138635
2020-05-11,1014,83623,,,,,,,115049,78889,160579,1981470,1414843,2683513,15202027,11247085,19861205,0.910948126277,0.833179773599,1.04861483672
2020-05-12,1627,85250,,,,,,,113354,77344,158822,1942265,1379450,2641207,15315381,11324429,20020027,0.91747454103,0.834068957966,1.07834063312
2020-05-13,1764,87014,,,,,,,111845,75919,157233,1904913,1345705,2601020,15427226,11400348,20177260,0.924775207018,0.835049271585,1.10557041268
2020-05-14,1783,88797,,,,,,,110538,74694,155924,1869520,1313664,2563156,15537764,11475042,20333184,0.932841834933,0.836435678817,1.12981938167
2020-05-15,1681,90478,,,,,,,109449,73679,154849,1836207,1283439,2527679,15647213,11548721,20488033,0.941680513946,0.838371339668,1.15032306837
2020-05-16,1216,91694,,,,,,,108593,72784,153869,1805110,1255063,2494481,15755806,11621505,20641902,0.951304029793,0.841244511616,1.16922844422
2020-05-17,758,92452,,,,,,,107983,72052,153265,1776378,1228647,2463869,15863789,11693557,20795167,0.961723087538,0.845143013822,1.18217791301
2020-05-18,1172,93624,,,,,,,107634,71545,153116,1750171,1204261,2436152,15971423,11765102,20948283,0.972937454599,0.850463116949,1.19486367039
2020-05-19,1552,95176,,,,,,,107556,71208,153476,1726659,1182015,2411849,16078979,11836310,21101759,0.98491867133,0.857314603655,1.22640235172
2020-05-20,1526,96702,,,,,,,107763,71107,153923,1706016,1162032,2390853,16186742,11907417,21255682,0.997581450888,0.865847029625,1.23724970463
2020-05-21,1217,97919,,,,,,,108264,71307,154770,1688425,1144716,2373431,16295006,11978724,21410452,1.01075874897,0.87540971203,1.2520797556
2020-05-22,1244,99163,,,,,,,109068,71816,156090,1674071,1130110,2359926,16404074,12050540,21566542,1.02420505403,0.875713320335,1.25716607329
2020-05-23,1109,100272,,,,,,,110186,72474,157490,1663142,1118248,2350260,16514260,12123014,21724032,1.03763873783,0.875828899515,1.26338372729
2020-05-24,622,100894,,,,,,,111626,73499,159289,1655826,1109393,2344678,16625886,12196513,21883321,1.05080685754,0.876028652376,1.27493507258
2020-05-25,548,101442,,,,,,,113399,74633,161527,1652308,1103507,2343619,16739285,12271146,22044848,1.06353870225,0.87669969841,1.28464419742
2020-05-26,662,102104,,,,,,,115523,76168,164201,1652781,1100839,2347200,16854808,12347314,22209049,1.0757617358,0.878409030822,1.29745010719
2020-05-27,1518,103622,,,,,,,118009,78028,167129,1657437,1101577,2355464,16972817,12425342,22376178,1.08747904285,0.879574655298,1.30689014513
2020-05-28,1178,104800,,,,,,,120864,80253,170768,1666456,1105966,2368951,17093681,12505595,22546946,1.09872739447,0.881580665792,1.31203796747
2020-05-29,1160,105960,,,,,,,124101,82760,174843,1680019,1114086,2387820,17217782,12588355,22721789,1.10954737519,0.883482338642,1.31753288782
2020-05-30,963,106923,,,,,,,127735,85481,179336,1698305,1125933,2412255,17345517,12673836,22901125,1.11999860831,0.886876576639,1.32547320663
2020-05-31,581,107504,,,,,,,131786,88642,184440,1721497,1141832,2442784,17477303,12762478,23085565,1.13012428121,0.891651946813,1.33453234104
2020-06-01,776,108280,,,,,,,136274,92158,190245,1749788,1161974,2479713,17613577,12854636,23275810,1.1399619949,0.898316390192,1.34123797564
2020-06-02,1068,109348,,,,,,,141217,96034,196207,1783372,1186499,2522753,17754794,12950670,23472017,1.1494875647,0.907876718557,1.34754893485
2020-06-03,1007,110355,,,,,,,146636,100089,203108,1822452,1215413,2572311,17901430,13050759,23675125,1.15862532907,0.920784509924,1.35198610784
2020-06-04,1023,111378,,,,,,,152552,104647,210615,1867240,1248977,2628918,18053982,13155406,23885740,1.16723906124,0.930477246459,1.35485354455
2020-06-05,914,112292,,,,,,,158983,109610,218705,1917959,1287300,2692772,18212965,13265016,24104445,1.17520716646,0.937140878358,1.35545658067
2020-06-06,659,112951,,,,,,,165949,114775,227317,1974840,1330268,2763906,18378914,13379791,24331762,1.18243679518,0.942959604711,1.35519597464
2020-06-07,438,113389,,,,,,,173470,120325,236786,2038124,1378127,2843109,18552384,13500116,24568548,1.18883854134,0.950376030183,1.35237565654
2020-06-08,519,113908,,,,,,,181561,126630,247896,2108059,1431258,2931610,18733945,13626746,24816444,1.194378614,0.959989905481,1.35354592601
2020-06-09,950,114858,,,,,,,190233,133109,259512,2184893,1489734,3029486,18924178,13759855,25075956,1.19900484082,0.972787524004,1.35304604901
2020-06-10,901,115759,,,,,,,199491,140116,270838,2268860,1553681,3136047,19123669,13899971,25346794,1.20270718996,0.988406492242,1.35351590655
2020-06-11,871,116630,,,,,,,209334,147622,283944,2360185,1623284,3252828,19333003,14047593,25630738,1.20548823759,1.00995466298,1.35370204011
2020-06-12,828,117458,,,,,,,219750,155289,297089,2459071,1698330,3379129,19552753,14202882,25927827,1.20734214121,1.03887945888,1.35395423652
2020-06-13,759,118217,,,,,,,230716,163691,311090,2565686,1779265,3515373,19783469,14366573,26238917,1.20828258427,1.05684614738,1.35559876552
2020-06-14,308,118525,,,,,,,242199,172574,325565,2680150,1866352,3661614,20025668,14539147,26564482,1.20828056901,1.05342673502,1.35481495256
2020-06-15,394,118919,,,,,,,254147,181929,339928,2802511,1959628,3817167,20279815,14721076,26904410,1.20735132439,1.04827300959,1.35616044911
2020-06-16,838,119757,,,,,,,266495,191519,355217,2932732,2058975,3982220,20546310,14912595,27259627,1.20547072305,1.03902627892,1.35601628495
2020-06-17,744,120501,,,,,,,279163,201382,371202,3070677,2164321,4157320,20825473,15113977,27630829,1.20264159313,1.02714460075,1.35704230594
2020-06-18,718,121219,,,,,,,292054,211475,385921,3216096,2275702,4340215,21117527,15325452,28016750,1.19886959864,1.01170119779,1.35781337946
2020-06-19,670,121889,,,,,,,305058,221462,401325,3368602,2392512,4530977,21422585,15546914,28418075,1.19414410605,1.00671155578,1.35813230478
2020-06-20,604,122493,,,,,,,318054,231860,415933,3527674,2514766,4728228,21740639,15778774,28834008,1.18848192716,0.992764344463,1.35802190088
2020-06-21,285,122778,,,,,,,330910,242401,431950,3692635,2642384,4932862,22071549,16021175,29265958,1.18189890765,0.989063877882,1.35762151654
2020-06-22,389,123167,,,,,,,343492,253398,446432,3862656,2775432,5142475,22415041,16274573,29712390,1.17449549022,0.983820088957,1.3569570763
2020-06-23,847,124014,,,,,,,355671,264207,460705,4036767,2912982,5355211,22770712,16538780,30173095,1.16640192574,0.97529035346,1.35565861455
2020-06-24,759,124773,,,,,,,367327,274406,473291,4213861,3054263,5568916,23138039,16813186,30646386,1.15776841738,0.96973846921,1.35410887925
2020-06-25,551,125324,,,,,,,378357,283736,485836,4392727,3197871,5783889,23516396,17096922,31132222,1.14875192444,0.963303987473,1.35304379666
2020-06-26,617,125941,,,,,,,388673,293500,498049,4572066,3343779,5998034,23905069,17390422,31630271,1.13947367022,0.956474590191,1.35193079756
2020-06-27,504,126445,,,,,,,398211,302446,509431,4750527,3490953,6210421,24303280,17692868,32139702,1.13006235891,0.945366571514,1.35164741179
2020-06-28,273,126718,,,,,,,406925,310547,519226,4926736,3637877,6418629,24710205,18003415,32658928,1.12061404398,0.940942112505,1.35025190621
2020-06-29,377,127095,,,,,,,414788,317167,527843,5099325,3782543,6621022,25124993,18320582,33186771,1.11121205185,0.93435235012,1.34673611615
2020-06-30,625,127720,,,,,,,421793,323098,535603,5266971,3923778,6816797,25546786,18643680,33722374,1.10191035658,0.92946628175,1.34431083694
2020-07-01,694,128414,,,,,,,427946,329137,542363,5428422,4061456,7004035,25974732,18972817,34264737,1.09272127254,0.926907467676,1.34194703449
2020-07-02,727,129141,,,,,,,433269,334413,548351,5582528,4194537,7181273,26408001,19307230,34813088,1.08363945316,0.922478989221,1.33419845996
2020-07-03,660,129801,,,,,,,437789,338605,552569,5728263,4321687,7347934,26845790,19645835,35365657,1.07463870093,0.91959312535,1.32424532588
2020-07-04,265,130066,,,,,,,441544,342506,556740,5864749,4442727,7503362,27287334,19988341,35922397,1.06571432881,0.916085728009,1.31532096813
2020-07-05,288,130354,,,,,,,444574,345477,560301,5991269,4556308,7647673,27731908,20333818,36482698,1.0568903021,0.912358549216,1.3092976688
2020-07-06,355,130709,,,,,,,446920,347871,563490,6107279,4661709,7779159,28178828,20681689,37046188,1.04822181899,0.908515548126,1.29996142662
2020-07-07,1222,131931,,,,,,,448628,349374,564470,6212416,4757615,7897130,28627456,21031063,37610658,1.03978157655,0.905065898451,1.28668939126
2020-07-08,863,132794,,,,,,,449741,350541,565928,6306486,4843878,8002273,29077197,21381604,38176586,1.03164705461,0.904134214471,1.27932391756
2020-07-09,1003,133797,,,,,,,450301,351263,566325,6389459,4920708,8095245,29527498,21732867,38742911,1.02388663401,0.902043134745,1.27217260196
2020-07-10,824,134621,,,,,,,450346,351517,566475,6461449,4988484,8175854,29977844,22084384,39309386,1.01655423373,0.899228596571,1.2617682939
2020-07-11,690,135311,,,,,,,449912,351367,566645,6522688,5046358,8244441,30427756,22435751,39876031,1.00969313975,0.898353650019,1.25089419991
2020-07-12,459,135770,,,,,,,449033,350608,565977,6573510,5094532,8300998,30876789,22786359,40442008,1.00333487564,0.897388246942,1.23655912761
2020-07-13,367,136137,,,,,,,447739,349441,564638,6614323,5133409,8346432,31324528,23135800,41006646,0.997493760757,0.895096887907,1.22154511884
2020-07-14,926,137063,,,,,,,446058,348263,563498,6645593,5164500,8382145,31770586,23484063,41570144,0.992163200469,0.893872566677,1.20214027554
2020-07-15,968,138031,,,,,,,444017,346767,561386,6667817,5188150,8407982,32214603,23830830,42131530,0.987319268266,0.893248725375,1.18490479223
2020-07-16,943,138974,,,,,,,441642,344784,558769,6681512,5203746,8424435,32656245,24175614,42690299,0.982929910056,0.892206136329,1.17446407926
2020-07-17,930,139904,,,,,,,438957,342157,555108,6687201,5211440,8431236,33095202,24517771,43245407,0.978963141048,0.890916390276,1.15869573893
2020-07-18,868,140772,,,,,,,435986,339153,552062,6685397,5211930,8430777,33531188,24856924,43797469,0.975389889625,0.890451891213,1.14063977729
2020-07-19,447,141219,,,,,,,432753,335740,548629,6676606,5205094,8422720,33963941,25192664,44346098,0.972182613376,0.89000478221,1.12801824208
2020-07-20,514,141733,,,,,,,429279,332399,544935,6661311,5191936,8407410,34393220,25525063,44891033,0.969313239686,0.88800885053,1.10397187636
2020-07-21,1107,142840,,,,,,,425586,328915,540702,6639977,5172907,8384675,34818806,25853978,45431735,0.966752409003,0.883313851863,1.08685941208
2020-07-22,1216,144056,,,,,,,421695,325830,536554,6613044,5149293,8356794,35240501,26179808,45968289,0.9644698103,0.879670495542,1.06822239166
2020-07-23,1094,145150,,,,,,,417625,322499,532581,6580928,5121190,8323476,35658126,26502307,46500870,0.962434870497,0.877083893994,1.05181537127
2020-07-24,1132,146282,,,,,,,413394,318718,528601,6544021,5088600,8285773,36071520,26821025,47029471,0.960617566759,0.876271788144,1.04432707109
2020-07-25,899,147181,,,,,,,409020,314247,524486,6502696,5051302,8243807,36480540,27135272,47553957,0.958989418492,0.875707305913,1.03939234117
2020-07-26,472,147653,,,,,,,404519,310042,520687,6457302,5009948,8197862,36885059,27445314,48074644,0.957524561466,0.875134738684,1.03824257842
2020-07-27,1120,148773,,,,,,,399905,305804,516905,6408174,4965118,8148807,37284964,27751118,48591549,0.956200607007,0.874420284301,1.03710928934
2020-07-28,1374,150147,,,,,,,395194,300897,512077,6355630,4916535,8096255,37680158,28052015,49103626,0.954998991738,0.8736634717,1.0333690213
2020-07-29,1432,151579,,,,,,,390398,296106,508210,6299971,4864336,8040974,38070556,28348121,49611836,0.953904703823,0.873123016942,1.02936669564
2020-07-30,1209,152788,,,,,,,385531,291371,503557,6241484,4808902,7983147,38456087,28639492,50115393,0.952905510834,0.872690038642,1.02816561088
2020-07-31,1243,154031,,,,,,,380602,286702,499115,6180445,4750783,7923506,38836689,28926194,50614508,0.951990989684,0.872272308932,1.02633601335
2020-08-01,1115,155146,,,,,,,375623,281796,494756,6117112,4690393,7863161,39212312,29207990,51109264,0.951151685173,0.871868500256,1.02569801672
2020-08-02,403,155549,,,,,,,370604,276553,490362,6051730,4627774,7801480,39582916,29484543,51599626,0.950378602,0.871477562887,1.02432042171
2020-08-03,530,156079,,,,,,,365554,271686,485516,5984531,4563701,7738378,39948470,29756229,52085142,0.949663055314,0.871098654357,1.02332231247
2020-08-04,1378,157457,,,,,,,360481,266598,480743,5915733,4497891,7674190,40308951,30022827,52565885,0.948996771365,0.870731087308,1.02285719733
2020-08-05,1376,158833,,,,,,,355392,261238,475896,5845539,4430211,7609383,40664343,30284065,53041781,0.94837208895,0.870374290873,1.02239167355
2020-08-06,1253,160086,,,,,,,350296,255970,471012,5774140,4360352,7543850,41014639,30540035,53512793,0.947782144122,0.870036733037,1.02192533269
2020-08-07,1242,161328,,,,,,,345199,250921,466163,5701714,4288781,7477426,41359838,30790956,53978956,0.947220978657,0.869738849893,1.02151050632
2020-08-08,1077,162405,,,,,,,340108,245985,461486,5628427,4216058,7410307,41699946,31036941,54440442,0.946683561919,0.869449380312,1.02106943935
2020-08-09,511,162916,,,,,,,335029,240889,457393,5554436,4142711,7343234,42034975,31277830,54897835,0.946165743368,0.869168034048,1.02028776088
2020-08-10,527,163443,,,,,,,329967,235868,452901,5479884,4068545,7275466,42364942,31513698,55350736,0.94566416167,0.86889454721,1.01974000298
2020-08-11,1064,164507,,,,,,,324929,230681,448238,5404908,3993426,7206819,42689871,31744379,55798974,0.945176134116,0.868628676773,1.01918990708
2020-08-12,1505,166012,,,,,,,319919,225590,442973,5329633,3918123,7137739,43009790,31969969,56241947,0.944699543492,0.868370196412,1.0186375099
2020-08-13,1070,167082,,,,,,,314941,220845,438268,5254176,3842867,7067819,43324731,32190814,56680215,0.944232732826,0.868118893337,1.01794241095
2020-08-14,1338,168420,,,,,,,310000,216222,433450,5178646,3767720,6997730,43634731,32407036,57113665,0.943774413123,0.867856045356,1.01728270319
2020-08-15,1034,169454,,,,,,,305099,211666,428626,5103143,3692687,6927267,43939830,32618702,57542291,0.943323585666,0.867602030995,1.01662950371
2020-08-16,571,170025,,,,,,,300241,206937,423907,5027761,3617828,6856439,44240071,32825639,57966198,0.942879478414,0.867332787413,1.0159712255
2020-08-17,446,170471,,,,,,,295429,202493,419355,4952585,3543767,6785450,44535500,33028132,58385553,0.94244149496,0.867068508812,1.0152945447
2020-08-18,1325,171796,,,,,,,290665,198106,414314,4877697,3470183,6714272,44826165,33226238,58799867,0.942009174207,0.866818625096,1.01465870074
2020-08-19,1353,173149,,,,,,,285952,193573,409596,4803168,3397152,6643145,45112117,33419811,59209463,0.941582158826,0.866574599976,1.01397947377
2020-08-20,1079,174228,,,,,,,281291,189218,404458,4729067,3325130,6571721,45393408,33609029,59613921,0.941160170804,0.866317247812,1.01330035467
2020-08-21,1105,175333,,,,,,,276683,184840,399841,4655454,3253999,6500569,45670091,33793869,60013762,0.9407429926,0.86602935919,1.01264198882
2020-08-22,982,176315,,,,,,,272130,180617,394775,4582386,3183693,6429198,45942221,33974486,60408537,0.940330452679,0.865750226652,1.01194000808
2020-08-23,450,176765,,,,,,,267633,176342,389829,4509911,3114049,6357553,46209854,34150828,60798366,0.939922414457,0.865479453664,1.01130339602
2020-08-24,442,177207,,,,,,,263456,172570,385443,4438339,3045731,6285613,46473310,34323398,61183809,0.940476010231,0.867483519157,1.01123635975
2020-08-25,1239,178446,,,,,,,259329,168878,381000,4367701,2978738,6213722,46732639,34492276,61564809,0.94103673264,0.86921360601,1.01107121113
2020-08-26,1225,179671,,,,,,,255265,165215,376805,4298036,2913267,6142300,46987904,34657491,61941614,0.941604118334,0.870704972665,1.01237962749
2020-08-27,1111,180782,,,,,,,251275,161636,372634,4229392,2849311,6071969,47239179,34819127,62314248,0.942178122513,0.871037636195,1.01335332459
2020-08-28,971,181753,,,,,,,247386,158012,368442,4161837,2786477,6002157,47486565,34977139,62682690,0.94275868958,0.872035131753,1.01393243182
2020-08-29,958,182711,,,,,,,243624,154617,364376,4095461,2724870,5933093,47730189,35131756,63047066,0.943345750501,0.872262569412,1.01615579265
2020-08-30,310,183021,,,,,,,239967,151235,360687,4030329,2664434,5865162,47970156,35282991,63407753,0.943939199992,0.871163829641,1.01828221992
2020-08-31,573,183594,,,,,,,236400,148101,357078,3966487,2605594,5798336,48206556,35431092,63764831,0.944538892678,0.870930772108,1.02051132749
2020-09-01,1067,184661,,,,,,,232921,144963,353868,3903979,2548058,5732846,48439477,35576055,64118699,0.945144717486,0.870878969729,1.02277599346
2020-09-02,1056,185717,,,,,,,229530,142080,350797,3842844,2492024,5669329,48669007,35718135,64469496,0.945756589437,0.870412212155,1.02452391612
2020-09-03,1070,186787,,,,,,,226237,139294,347926,3783129,2437735,5607669,48895244,35857429,64817422,0.946374424228,0.870446586948,1.02717480258
2020-09-04,965,187752,,,,,,,223041,136536,344609,3724879,2385044,5547820,49118285,35993965,65162031,0.946998136051,0.868893722901,1.02929265001
2020-09-05,783,188535,,,,,,,219936,133686,341866,3668132,2333882,5489835,49338221,36127651,65503897,0.947627623489,0.868896775128,1.03158869446
2020-09-06,403,188938,,,,,,,216920,131022,339634,3612921,2284280,5434671,49555141,36258673,65843531,0.948262785113,0.8696031217,1.03321299586
2020-09-07,267,189205,,,,,,,213991,128385,337552,3559279,2236321,5382355,49769132,36387058,66181083,0.948903525111,0.86955635158,1.03509940182
2020-09-08,445,189650,,,,,,,211151,125797,335439,3506974,2189547,5332298,49980283,36512855,66516522,0.949549750741,0.870357507256,1.03763407557
2020-09-09,,,767.115954496,545,1064,190417.115954,190195,190714,208399,123299,332980,3456044,2143966,5284232,50188682,36636154,66849502,0.950201368836,0.870554343798,1.0399907318
2020-09-10,,,755.78639,534,1054,191172.902344,190729,191768,205735,120888,330769,3406515,2099642,5238166,50394417,36757042,67180271,0.950858281867,0.869965994535,1.04234202439
2020-09-11,,,744.503995173,522,1044,191917.40634,191252,192811,203157,118499,328391,3358397,2056509,5193905,50597574,36875541,67508662,0.95152038917,0.870048194775,1.04467842256
2020-09-12,,,733.287936242,511,1033,192650.694276,191764,193843,200663,116196,325867,3311673,2014697,5151330,50798237,36991737,67834529,0.952187589379,0.869180675372,1.04704324741
2020-09-13,,,722.155402219,500,1022,193372.849678,192264,194864,198254,113977,323512,3266303,1974063,5110476,50996491,37105714,68158041,0.952859780752,0.868107816558,1.0495759061
2020-09-14,,,711.120004949,490,1012,194083.969683,192755,195876,195928,111700,321195,3222264,1934535,5070994,51192419,37217414,68479236,0.953536860496,0.866579105939,1.05196774354
2020-09-15,,,700.195449929,480,1001,194784.165133,193235,196876,193687,109777,319553,3179551,1896217,5033478,51386106,37327191,68798789,0.95421872343,0.864505849776,1.05469611911
2020-09-16,,,689.395407354,470,991,195473.56054,193705,197866,191528,107779,317607,3138159,1859038,4997228,51577634,37434970,69116396,0.954905261583,0.862937928882,1.05710027914
2020-09-17,,,678.733167043,459,979,196152.293707,194165,198845,189451,105741,315640,3098079,1822704,4962085,51767085,37540711,69432036,0.955596364561,0.861734180451,1.06038247493
2020-09-18,,,668.220997258,449,967,196820.514705,194615,199812,187456,103857,314334,3059298,1787272,4928511,51954541,37644568,69746370,0.9562919198,0.861113527483,1.0629313976
2020-09-19,,,657.86738507,440,957,197478.38209,195055,200768,185543,101994,313261,3021800,1752733,4897173,52140084,37746562,70059631,0.956991812451,0.861002292751,1.0643805718
2020-09-20,,,647.680716964,430,947,198126.062807,195486,201715,183710,100119,312502,2985574,1719167,4867814,52323794,37846681,70372133,0.957695924949,0.859933331154,1.06722142586
2020-09-21,,,637.669346803,421,936,198763.732153,195907,202651,181959,98187,311777,2950613,1686330,4839950,52505753,37944868,70683910,0.958404136636,0.857807235693,1.07032280032
2020-09-22,,,627.84147161,412,927,199391.573625,196319,203577,180288,96397,311708,2916910,1654340,4814100,52686041,38041265,70995618,0.959116323623,0.856317451639,1.07366515944
2020-09-23,,,618.20476122,403,917,200009.778386,196722,204493,178698,94605,311207,2884456,1623144,4789858,52864739,38135870,71306825,0.959832358724,0.854205414528,1.07651538512
2020-09-24,,,608.760768595,394,906,200618.539155,197117,205399,177187,92810,311093,2853244,1592648,4767971,53041926,38228680,71617918,0.960552111335,0.852103521632,1.07878491436
2020-09-25,,,599.511672705,386,896,201218.050828,197503,206295,175757,91200,311341,2823266,1562953,4748557,53217683,38319880,71929259,0.961275447191,0.850148955032,1.08041595334
2020-09-26,,,590.46008905,377,887,201808.510917,197881,207180,174408,89500,311887,2794517,1533945,4732068,53392091,38409380,72241146,0.962002228091,0.848361079897,1.08476993717
2020-09-27,,,581.608746869,369,878,202390.119664,198251,208058,173138,87956,312674,2766992,1505697,4718891,53565229,38497336,72553820,0.962732311641,0.846302685848,1.08815363879
2020-09-28,,,572.959922079,361,869,202963.079586,198613,208926,171949,86440,313583,2740687,1478155,4708976,53737178,38583776,72867403,0.963465551045,0.844325162095,1.0913420559
2020-09-29,,,564.514804578,354,862,203527.59439,198967,209787,170841,85006,314630,2715599,1451459,4702415,53908019,38668782,73182033,0.964201794877,0.842356469104,1.09452838883
2020-09-30,,,556.274096373,346,854,204083.868487,199314,210640,169813,83569,316196,2691726,1425250,4699057,54077832,38752351,73498229,0.964940886828,0.840295226418,1.09785113489
2020-10-01,,,548.238451123,339,846,204632.106938,199654,211486,168868,82087,317276,2669066,1399559,4698716,54246700,38834438,73815505,0.96568989787,0.839782625686,1.10128220018
2020-10-02,,,540.40851359,332,839,205172.515451,199987,212324,168004,80694,318557,2647619,1374513,4701614,54414704,38915132,74134062,0.966444629896,0.837608995074,1.10407359718
2020-10-03,,,532.784902679,326,832,205705.300354,200314,213155,167223,79419,320943,2627386,1350078,4708206,54581927,38994551,74455005,0.967201864787,0.835670675146,1.10685694582
2020-10-04,,,525.367893823,319,826,206230.668248,200633,213981,166525,78143,324170,2608369,1326231,4719096,54748452,39072694,74779175,0.967965048351,0.834159562893,1.1104841655
2020-10-05,,,518.15748064,312,821,206748.825728,200946,214801,165911,76981,326479,2590570,1303097,4733047,54914363,39149675,75105654,0.968736480496,0.832654055198,1.11370124262
2020-10-06,,,511.153513911,306,815,207259.979242,201252,215615,165382,75822,328996,2573993,1280735,4750236,55079745,39225497,75434650,0.969511572169,0.831154061173,1.11691225525
2020-10-07,,,504.355790133,300,809,207764.335032,201552,216423,164938,74569,332115,2558644,1258910,4770624,55244683,39300066,75766765,0.970288186581,0.829483124803,1.12011631933
2020-10-08,,,497.764073962,294,803,208262.099106,201847,217225,164581,73358,336311,2544528,1237664,4795715,55409264,39373424,76103076,0.971066762028,0.827872427166,1.12331250405
2020-10-09,,,491.377935906,288,797,208753.477042,202135,218021,164312,72142,340277,2531652,1216998,4824894,55573576,39445566,76443353,0.971854272405,0.826061438406,1.12857683338
2020-10-10,,,485.196750776,282,791,209238.673793,202418,218812,164131,71057,345097,2520026,1196857,4858647,55737707,39516623,76788450,0.9726511,0.824449787702,1.13209942053
2020-10-11,,,479.219734159,277,786,209717.893527,202696,219597,164041,69990,348882,2509660,1177346,4895643,55901748,39586613,77137332,0.973451512238,0.82306385242,1.13552834147
2020-10-12,,,473.445978095,271,781,210191.339505,202967,220376,164042,68954,352908,2500564,1158343,4935874,56065790,39655567,77490240,0.974253450193,0.822444557327,1.13750472186
2020-10-13,,,467.874583743,266,776,210659.214089,203234,221151,164137,67892,357875,2492752,1139795,4980165,56229927,39723459,77848115,0.975058220176,0.821257189127,1.14253957315
2020-10-14,,,462.504751502,261,771,211121.718841,203496,221920,164326,66854,363495,2486236,1121642,5029036,56394253,39790313,78211610,0.975868342298,0.821177084378,1.14713743299
2020-10-15,,,457.335637858,256,765,211579.054478,203753,222684,164611,65836,369087,2481034,1103908,5081938,56558864,39856149,78580697,0.976700259386,0.821140162752,1.14991446126
2020-10-16,,,452.366369109,251,762,212031.420848,204005,223445,164995,65024,374275,2477161,1086844,5138941,56723859,39921173,78954972,0.977536616466,0.820560973801,1.15259845376
2020-10-17,,,447.596076062,247,759,212479.016924,204253,224202,165479,64112,380613,2474636,1070262,5200997,56889338,39985285,79335585,0.978372866017,0.819828410716,1.15591191377
2020-10-18,,,443.02394268,242,757,212922.040866,204496,224957,166066,63209,386905,2473479,1054051,5266959,57055404,40048494,79722490,0.979208890803,0.819391677273,1.15968878405
2020-10-19,,,438.649352353,238,755,213360.690219,204735,225710,166757,62317,394043,2473710,1038225,5336837,57222161,40110811,80116533,0.980047399302,0.818288867615,1.16342199772
2020-10-20,,,434.471754881,234,753,213795.161974,204970,226462,167556,61492,401658,2475355,1022736,5412016,57389717,40172303,80518191,0.980889767236,0.817221356545,1.16656185857
2020-10-21,,,430.490669266,229,753,214225.652643,205200,227213,168464,60677,409414,2478437,1007589,5492427,57558181,40232980,80927605,0.981734829617,0.818262708077,1.17061210939
2020-10-22,,,426.705696577,225,752,214652.358339,205426,227963,169485,59835,417828,2482984,992855,5578133,57727666,40292815,81345433,0.982594421342,0.817826065611,1.1746512903
2020-10-23,,,423.116550922,221,751,215075.47489,205648,228712,170621,59086,426790,2489023,978582,5668609,57898287,40351901,81772223,0.983454302497,0.816951803203,1.17725132469
2020-10-24,,,419.723325379,217,753,215495.198216,205866,229463,171875,58373,435894,2496587,964812,5764230,58070162,40410274,82208117,0.984312551979,0.817411517917,1.18033395042
2020-10-25,,,416.526233489,213,754,215911.724449,206080,230215,173251,57655,445602,2505707,951409,5864737,58243413,40467929,82653719,0.985169596353,0.816948831205,1.18297175268
2020-10-26,,,413.525619231,209,756,216325.250068,206290,230969,174752,57030,455063,2516417,938450,5970914,58418165,40524959,83108782,0.986028336683,0.816855663621,1.18678163673
2020-10-27,,,410.721972042,206,759,216735.97204,206497,231726,176380,56263,465019,2528755,925760,6083017,58594545,40581222,83573801,0.986882455791,0.816605260787,1.19057888309
2020-10-28,,,408.115961535,202,763,217144.088002,206700,232486,178141,55636,476172,2542760,913505,6201310,58772686,40636858,84049973,0.987733522963,0.816007417471,1.19436186679
2020-10-29,,,405.708477276,199,766,217549.796479,206900,233250,180037,54985,487512,2558471,901637,6325334,58952723,40691843,84537485,0.988584483753,0.815220262686,1.19808026709
2020-10-30,,,403.500616301,195,767,217953.297096,207096,234015,182072,54464,499949,2575932,890264,6456207,59134795,40746307,85037434,0.989436509699,0.814692052674,1.20169093605
2020-10-31,,,401.493672179,192,772,218354.790768,207289,234783,184252,53905,512629,2595189,879145,6594568,59319047,40800212,85550063,0.990283376444,0.813473048149,1.20462950317
2020-11-01,,,399.689132811,189,779,218754.479901,207479,235559,186578,53306,526991,2616288,868338,6740956,59505625,40853518,86077054,0.991124741163,0.812301455276,1.20710981885
