date,actual_deaths,total_deaths,predicted_deaths_mean,predicted_deaths_lower,predicted_deaths_upper,predicted_total_deaths_mean,predicted_total_deaths_lower,predicted_total_deaths_upper,predicted_new_infected_mean,predicted_new_infected_lower,predicted_new_infected_upper,predicted_current_infected_mean,predicted_current_infected_lower,predicted_current_infected_upper,predicted_total_infected_mean,predicted_total_infected_lower,predicted_total_infected_upper,r_values_mean,r_values_lower,r_values_upper
2020-02-05,0,0,,,,,,,126,66,178,126,66,178,126,66,178,2.26263822936,2.1,2.4
2020-02-06,0,0,,,,,,,126,66,178,252,132,356,252,132,356,2.2626285214,2.09998877772,2.39999969824
2020-02-07,0,0,,,,,,,126,66,178,377,197,534,378,198,534,2.26262524442,2.09998489786,2.39999953778
2020-02-08,0,0,,,,,,,126,66,178,503,264,712,504,264,712,2.26262084858,2.09997950831,2.3999992909
2020-02-09,0,0,,,,,,,287,163,404,790,442,1102,791,427,1116,2.26261494686,2.09997269754,2.39999891216
2020-02-10,0,0,,,,,,,287,163,404,1076,610,1501,1078,590,1520,2.26260701635,2.09996359601,2.399998331
2020-02-11,0,0,,,,,,,287,163,404,1363,776,1902,1365,753,1924,2.26259634976,2.0999514535,2.39999743843
2020-02-12,0,0,,,,,,,287,163,404,1650,942,2304,1652,916,2328,2.26258198927,2.09993526105,2.39999622461
2020-02-13,0,0,,,,,,,460,278,648,2110,1237,2929,2112,1194,2976,2.26256263621,2.09991366804,2.39999435151
2020-02-14,0,0,,,,,,,670,408,938,2780,1650,3861,2782,1602,3914,2.26250711051,2.09985908101,2.39996716274
2020-02-15,0,0,,,,,,,1208,746,1629,3987,2450,5450,3990,2348,5543,2.26246817304,2.09981801525,2.39996009063
2020-02-16,0,0,,,,,,,2404,1464,3095,6392,4042,8483,6394,3812,8638,2.26240850708,2.09974962984,2.3999432619
2020-02-17,0,0,,,,,,,3885,2517,4923,10277,6691,13318,10279,6329,13561,2.26233202214,2.09966236507,2.39992346182
2020-02-18,0,0,,,,,,,4301,2829,5457,14578,9560,18748,14580,9158,19018,2.26223170827,2.09955662944,2.39989896554
2020-02-19,0,0,,,,,,,5050,3378,6403,19628,12999,25104,19630,12536,25421,2.26209833479,2.09940989567,2.39986592299
2020-02-20,0,0,,,,,,,5191,3480,6596,24693,16424,31512,24821,16016,32017,2.26191856997,2.09922835456,2.39981675752
2020-02-21,0,0,,,,,,,5721,3894,7262,30288,20274,38575,30542,19910,39279,2.26167467385,2.09899987098,2.39975042871
2020-02-22,0,0,,,,,,,6792,4691,8631,36955,24946,46990,37334,24601,47910,2.26134634785,2.09870400356,2.39965823477
2020-02-23,0,0,,,,,,,8133,5707,10315,44962,30680,57052,45467,30308,58225,2.26090440437,2.09831199069,2.39952999248
2020-02-24,0,0,,,,,,,10338,7250,13190,55014,37847,69779,55805,37558,71415,2.26030712251,2.09777099684,2.399345436
2020-02-25,0,0,,,,,,,16235,10827,20664,70961,48686,89920,72040,48385,92079,2.2594972135,2.09705724422,2.39908002075
2020-02-26,0,0,,,,,,,19614,13314,25037,90288,61881,114515,91654,61699,117116,2.25839588426,2.09611812199,2.39870221665
2020-02-27,0,0,,,,,,,21389,14410,27554,111391,76142,141652,113043,76109,144670,2.25689658778,2.09486872465,2.39813596081
2020-02-28,0,0,,,,,,,25981,17355,33787,136911,93217,174786,139024,93464,178457,2.25485301667,2.09320824924,2.39731559859
2020-02-29,1,1,,,,,,,31796,20673,42000,168037,113492,215807,170820,114137,220457,2.25206375562,2.09100976814,2.39612525523
2020-03-01,0,1,,,,,,,41320,26277,55280,208150,139087,269344,212140,140414,275737,2.2482528839,2.08810035959,2.39437426098
2020-03-02,5,6,,,,,,,51402,32389,69452,257148,170118,335550,263542,172803,345189,2.24304458618,2.08415423361,2.39174176645
2020-03-03,1,7,,,,,,,63781,39994,86849,317044,207690,417329,327323,212797,432038,2.23593114897,2.07882774524,2.38784497708
2020-03-04,4,11,,,,,,,78292,48418,107584,391034,253381,519285,405615,261215,539622,2.22623325521,2.07193695161,2.38207368036
2020-03-05,1,12,,,,,,,97943,59949,135753,483927,310055,648430,503558,321164,675375,2.21305547708,2.06229623681,2.37340931865
2020-03-06,2,14,,,,,,,120065,72773,168026,598801,379458,809608,623623,393937,843401,2.19524461556,2.04745753139,2.36094668886
2020-03-07,3,17,,,,,,,145085,88116,203566,738165,463768,1005727,768708,482053,1046967,2.17136587133,2.02688610917,2.34250928955
2020-03-08,4,21,,,,,,,172438,106076,240605,903811,565145,1237607,941146,588129,1287572,2.13972419748,1.98863102091,2.31522130918
2020-03-09,1,22,,,,,,,201377,127222,276032,1097055,686535,1503357,1142523,715351,1563604,2.09847127392,1.93201874251,2.28022383626
2020-03-10,6,28,,,,,,,230827,152222,311950,1317543,831254,1802258,1373350,867573,1875554,2.04584345684,1.86459378554,2.25835589814
2020-03-11,5,33,,,,,,,257027,173732,344010,1558336,994118,2125562,1630377,1041305,2219564,1.98055119072,1.78105780594,2.21638684388
2020-03-12,10,43,,,,,,,278411,189370,371011,1817133,1170042,2471555,1908788,1230675,2590575,1.90226618219,1.68211446365,2.17875870463
2020-03-13,8,51,,,,,,,294814,203831,390816,2090559,1359354,2834788,2203602,1434506,2981391,1.81204773806,1.57117022406,2.11251309545
2020-03-14,7,58,,,,,,,306048,211102,401946,2370626,1553028,3202871,2509650,1645608,3383337,1.71249697268,1.45659567074,2.04565462982
2020-03-15,12,70,,,,,,,313477,218142,412243,2652307,1750572,3572955,2823127,1863750,3795580,1.60751237685,1.33871114628,1.97758151973
2020-03-16,27,97,,,,,,,317552,223508,422659,2928539,1948042,3940122,3140679,2087258,4218239,1.50170458882,1.21984178836,1.89282413985
2020-03-17,35,132,,,,,,,319175,227448,427046,3196312,2143490,4297491,3459854,2314706,4645285,1.39967014445,1.1254064364,1.78541893059
2020-03-18,59,191,,,,,,,319204,231036,427349,3451735,2335146,4637689,3779058,2545742,5072634,1.30534026648,1.05243208642,1.66948032151
2020-03-19,73,264,,,,,,,318159,234096,424542,3691602,2521711,4954169,4097217,2779838,5497176,1.22154253808,1.00230003487,1.54512924113
2020-03-20,99,363,,,,,,,316505,235871,422378,3910164,2698778,5240111,4413722,3015709,5919554,1.14981744928,0.966519363549,1.44295913893
2020-03-21,99,462,,,,,,,314347,237166,419642,4104446,2864543,5491000,4728069,3252875,6339196,1.09046934671,0.939501524017,1.34210752087
2020-03-22,110,572,,,,,,,311774,238389,415383,4271134,3016323,5702086,5039843,3491264,6754579,1.04280029907,0.922689297573,1.25901867361
2020-03-23,189,761,,,,,,,308915,238298,409766,4407611,3150176,5870539,5348758,3729562,7164345,1.00545103696,0.903292320097,1.18780117434
2020-03-24,239,1000,,,,,,,305806,237624,402329,4512040,3262108,5995962,5654564,3967186,7566674,0.976755020926,0.883267836025,1.12407057653
2020-03-25,324,1324,,,,,,,302478,234728,394897,4583691,3345773,6077881,5957042,4201914,7961571,0.955024207736,0.869959727776,1.07170916049
2020-03-26,408,1732,,,,,,,298922,233650,388536,4625586,3406776,6121511,6255964,4435564,8350107,0.938729213481,0.860674265898,1.03309418047
2020-03-27,518,2250,,,,,,,295120,231218,381763,4642294,3449206,6131379,6551084,4666782,8731870,0.926581456787,0.854208047494,1.005451883
2020-03-28,633,2883,,,,,,,291076,227520,374358,4638555,3472888,6114076,6842160,4894302,9106228,0.917547219348,0.849260868135,0.983640222347
2020-03-29,586,3469,,,,,,,286824,223799,367062,4619331,3484871,6078430,7128984,5118101,9473290,0.910824575935,0.845816972727,0.970924968685
2020-03-30,692,4161,,,,,,,282315,219503,359708,4588170,3485060,6025470,7411299,5337604,9832998,0.9058055285,0.843327354269,0.962109930935
2020-03-31,1085,5246,,,,,,,277597,215291,352736,4548214,3475249,5955655,7688896,5552895,10185734,0.902036258216,0.841836040731,0.95693711334
2020-04-01,1172,6418,,,,,,,272686,210895,345419,4501725,3456972,5874643,7961582,5763790,10531153,0.899181576099,0.840615593386,0.952572366121
2020-04-02,1503,7921,,,,,,,267609,206505,338428,4450131,3430811,5786643,8229191,5970295,10869581,0.89699562522,0.839612950483,0.949025392431
2020-04-03,1392,9313,,,,,,,262394,202145,331992,4394366,3397429,5695111,8491585,6172440,11201573,0.895298863273,0.838442069155,0.946495943817
2020-04-04,1523,10836,,,,,,,257065,197734,325223,4334926,3358021,5599028,8748650,6370174,11526796,0.893960512514,0.837640067446,0.944463486679
2020-04-05,1590,12426,,,,,,,251658,193344,318672,4272237,3313256,5499307,9000308,6563518,11845468,0.89288543509,0.836983548957,0.943062302598
2020-04-06,1770,14196,,,,,,,246206,188862,312166,4206670,3263102,5397402,9246514,6752380,12157634,0.892004441503,0.836486655103,0.94169875711
2020-04-07,2571,16767,,,,,,,240745,184375,305257,4138499,3208803,5294142,9487259,6936755,12462891,0.891267193004,0.835817671867,0.940925411443
2020-04-08,2146,18913,,,,,,,235306,180067,298484,4068000,3150986,5191258,9722565,7116822,12761375,0.890637030983,0.835308360072,0.940239327849
2020-04-09,2228,21141,,,,,,,229918,175795,291597,3995439,3091819,5088685,9952483,7292617,13052972,0.890087222353,0.834815161022,0.939663103377
2020-04-10,2218,23359,,,,,,,224604,171754,285027,3921122,3029775,4985785,10177087,7464371,13337999,0.889598238142,0.834422434386,0.93920280819
2020-04-11,2119,25478,,,,,,,219384,167631,278675,3845386,2966061,4883130,10396471,7632002,13616674,0.889152968946,0.834054805614,0.938716702965
2020-04-12,1816,27294,,,,,,,214269,163561,272379,3768579,2901998,4781415,10610740,7795563,13889053,0.888744276947,0.833598464995,0.938388220152
2020-04-13,1946,29240,,,,,,,209270,159560,266287,3691025,2837692,4680790,10820010,7955123,14155340,0.888363926834,0.83328033181,0.93800908302
2020-04-14,2455,31695,,,,,,,204391,155578,260390,3613102,2773741,4581557,11024401,8110701,14415730,0.888006484882,0.832935147407,0.937671324016
2020-04-15,2609,34304,,,,,,,199635,151857,254802,3535140,2710307,4483653,11224036,8262558,14670532,0.887677231049,0.832595395741,0.937328626486
2020-04-16,2176,36480,,,,,,,195000,148227,249287,3457454,2647668,4387522,11419036,8410785,14919819,0.887362358967,0.832312719314,0.937002262843
2020-04-17,2093,38573,,,,,,,190487,144553,243953,3380331,2585765,4293049,11609523,8555338,15163772,0.887063210843,0.832068386203,0.936699786458
2020-04-18,1960,40533,,,,,,,186091,140790,238877,3304028,2524463,4199933,11795614,8696128,15402649,0.886778482141,0.831796859025,0.936413737835
2020-04-19,1931,42464,,,,,,,181810,137275,233958,3228773,2464049,4108687,11977424,8833403,15636607,0.886509143915,0.831478712799,0.936132002098
2020-04-20,2186,44650,,,,,,,177641,133749,229241,3154756,2404484,4019297,12155065,8967152,15865848,0.886254634434,0.831235625373,0.935861502316
2020-04-21,2548,47198,,,,,,,173580,130457,224678,3082130,2346086,3931864,12328645,9097609,16090526,0.886015597578,0.831020495074,0.935595778876
2020-04-22,2434,49632,,,,,,,169624,127089,220273,3011009,2288784,3846959,12498269,9224698,16310799,0.88579305415,0.830842287145,0.935335801281
2020-04-23,2466,52098,,,,,,,165771,123674,215914,2941474,2232364,3764497,12664040,9348372,16526713,0.885590344038,0.830673040806,0.935083569594
2020-04-24,2154,54252,,,,,,,162019,120536,211743,2873575,2177059,3684760,12826059,9468908,16738456,0.885411641602,0.830453422558,0.934962799954
2020-04-25,1698,55950,,,,,,,158366,117441,207484,2807336,2122683,3607338,12984425,9586349,16945940,0.8852627251,0.83028667306,0.93475467749
2020-04-26,1329,57279,,,,,,,154811,114349,203578,2742764,2069342,3532348,13139236,9700698,17149518,0.88515195544,0.830117782847,0.934512682267
2020-04-27,1466,58745,,,,,,,151352,111269,199747,2679846,2016991,3459810,13290588,9811967,17349265,0.885089939564,0.830052860419,0.934285118139
2020-04-28,2241,60986,,,,,,,147986,108256,196010,2618562,1965639,3389608,13438574,9920223,17545275,0.88509137113,0.830009144547,0.934182101702
2020-04-29,2521,63507,,,,,,,144716,105298,192459,2558887,1915318,3321738,13583290,10025521,17737734,0.885175866824,0.829957364221,0.933978643827
2020-04-30,2322,65829,,,,,,,141542,102327,189017,2500794,1865753,3255997,13724832,10127848,17926751,0.885369307953,0.829976210076,0.93403239792
2020-05-01,1891,67720,,,,,,,138462,99603,185674,2444256,1817100,3192414,13863294,10227451,18112425,0.885705618614,0.829981466322,0.934039453967
2020-05-02,1692,69412,,,,,,,135478,97013,182459,2389247,1769536,3130937,13998772,10324464,18294884,0.886228662848,0.829994425069,0.934082944051
2020-05-03,1120,70532,,,,,,,132590,94474,179420,2335746,1723199,3071482,14131362,10418938,18474304,0.886994030192,0.830092078356,0.934585890835
2020-05-04,1333,71865,,,,,,,129803,91860,176355,2283739,1677764,3013872,14261165,10510798,18650659,0.888070358335,0.830256700565,0.935409913101
2020-05-05,2318,74183,,,,,,,127119,89384,173458,2233217,1633384,2958074,14388284,10600182,18824117,0.889539283262,0.830416299642,0.936817739712
2020-05-06,2364,76547,,,,,,,124541,87087,170607,2184179,1589996,2903985,14512825,10687269,18994724,0.891492911192,0.830527263578,0.940611817868
2020-05-07,1934,78481,,,,,,,122075,84859,168032,2136629,1547753,2851723,14634900,10772128,19162756,0.89402758018,0.831151475943,0.953966424709
2020-05-08,1747,80228,,,,,,,119725,82800,165565,2090584,1506867,2801353,14754625,10854928,19328321,0.897233432214,0.831719176754,0.969655896242
2020-05-09,1488,81716,,,,,,,117500,80736,163156,2046065,1467052,2752744,14872125,10935664,19491477,0.901181459665,0.832070810539,0.991073804317
2020-05-10,893,82609,,,,,,,115409,78810,160941,2003108,1428406,2706183,14987534,11014474,19652418,0.905912925265,0.832450163079,1.01600898268
2020-05-11,1014,83623,,,,,,,113462,76999,158775,1961759,1391045,2661368,15100996,11091473,19811193,0.91143791083,0.832804253015,1.04855811916
2020-05-12,1627,85250,,,,,,,111672,75420,156898,1922079,1355185,2618508,15212668,11166893,19968091,0.917746369306,0.833932287459,1.07383898882
2020-05-13,1764,87014,,,,,,,110052,74007,155302,1884146,1320928,2577790,15322720,11240900,20123393,0.924826239474,0.834797343303,1.09706530226
2020-05-14,1783,88797,,,,,,,108618,72675,153741,1848047,1288300,2539062,15431338,11313575,20277134,0.932676580828,0.836271815884,1.12267276127
2020-05-15,1681,90478,,,,,,,107383,71476,152500,1813889,1257449,2502533,15538721,11385051,20429634,0.941307982666,0.838222599699,1.14531165441
2020-05-16,1216,91694,,,,,,,106364,70481,151395,1781791,1228332,2468244,15645085,11455532,20581029,0.950734321887,0.840931202761,1.16407970744
2020-05-17,758,92452,,,,,,,105575,69660,150676,1751888,1200987,2436450,15750660,11525192,20731705,0.960964969916,0.844495513709,1.17799664942
2020-05-18,1172,93624,,,,,,,105030,68953,150262,1724328,1175482,2407281,15855690,11594145,20881967,0.971998051003,0.849367599556,1.19474646863
2020-05-19,1552,95176,,,,,,,104742,68449,150307,1699267,1152092,2381212,15960432,11662594,21032274,0.983805191129,0.855955267947,1.2262161289
2020-05-20,1526,96702,,,,,,,104726,68157,150568,1676874,1130894,2358296,16065158,11730751,21182842,0.996303647397,0.864781037194,1.23610736111
2020-05-21,1217,97919,,,,,,,104992,68164,151023,1657324,1112004,2338685,16170150,11798915,21333865,1.00933035234,0.874806383097,1.2526408981
2020-05-22,1244,99163,,,,,,,105552,68311,151976,1640801,1095491,2322594,16275702,11867226,21485841,1.02264286338,0.875618134539,1.2571178728
2020-05-23,1109,100272,,,,,,,106417,68766,153378,1627494,1081496,2310363,16382119,11935992,21639219,1.0359590233,0.875677476953,1.26027275415
2020-05-24,622,100894,,,,,,,107599,69367,155104,1617592,1070171,2302260,16489718,12005359,21794323,1.04901981498,0.876000524782,1.26801627692
2020-05-25,548,101442,,,,,,,109106,70329,157118,1611289,1061737,2298388,16598824,12075688,21951441,1.06164247561,0.876480871653,1.28143125939
2020-05-26,662,102104,,,,,,,110958,71481,159271,1608785,1056273,2298840,16709782,12147169,22110712,1.07373761264,0.877432777646,1.29680856896
2020-05-27,1518,103622,,,,,,,113166,72999,162069,1610279,1053905,2303961,16822948,12220168,22272781,1.08528886292,0.878687269719,1.30626347183
2020-05-28,1178,104800,,,,,,,115736,74849,165329,1615962,1054803,2313934,16938684,12295017,22438110,1.09631608344,0.880944186086,1.31205115557
2020-05-29,1160,105960,,,,,,,118678,77030,169055,1626023,1059208,2329187,17057362,12372047,22607165,1.1068395623,0.882973470542,1.32022178416
2020-05-30,963,106923,,,,,,,122010,79612,173420,1640650,1067389,2350037,17179372,12451659,22780585,1.11691048596,0.886027715543,1.33239778239
2020-05-31,581,107504,,,,,,,125747,82292,178036,1660032,1079237,2376610,17305119,12533951,22958621,1.12656966029,0.890832502854,1.34038585588
2020-06-01,776,108280,,,,,,,129909,85396,183556,1684366,1095005,2409417,17435028,12619347,23142177,1.13587018241,0.897758076912,1.34619536118
2020-06-02,1068,109348,,,,,,,134512,88700,189921,1713849,1114782,2449004,17569540,12708047,23332098,1.1448199739,0.90698613151,1.35013089129
2020-06-03,1007,110355,,,,,,,139577,92566,196661,1748684,1138922,2495279,17709117,12800613,23528759,1.15339538255,0.920137429396,1.35274108163
2020-06-04,1023,111378,,,,,,,145122,96737,203877,1789080,1167514,2548491,17854239,12897350,23732636,1.16152427947,0.928654348146,1.35528243013
2020-06-05,914,112292,,,,,,,151167,101322,211642,1835256,1200679,2609014,18005406,12998672,23944278,1.16913578066,0.933882070166,1.35566739086
2020-06-06,659,112951,,,,,,,157732,106234,219917,1887436,1238603,2676878,18163138,13104906,24164195,1.17617462578,0.938982010813,1.35577328792
2020-06-07,438,113389,,,,,,,164837,111681,228987,1945856,1281525,2752427,18327975,13216587,24393182,1.18257203673,0.946114190441,1.35608540949
2020-06-08,519,113908,,,,,,,172499,117504,239414,2010756,1329667,2836686,18500474,13334091,24632596,1.18828612825,0.954863025693,1.35521511527
2020-06-09,950,114858,,,,,,,180731,123715,250162,2082381,1383060,2929688,18681205,13457806,24882758,1.19325237477,0.966706834372,1.35604784233
2020-06-10,901,115759,,,,,,,189544,130558,261914,2160968,1442142,3032304,18870749,13588364,25144672,1.19742217181,0.981923900518,1.35521562451
2020-06-11,871,116630,,,,,,,198938,137702,274481,2246740,1506844,3144704,19069687,13726066,25419153,1.20076760854,1.00632229915,1.35508521255
2020-06-12,828,117458,,,,,,,208910,145287,288614,2339915,1577288,3267977,19278597,13871353,25707767,1.20324683849,1.03160502382,1.35515895816
2020-06-13,759,118217,,,,,,,219443,153248,302484,2440680,1653494,3401392,19498040,14024601,26010251,1.20484178099,1.05529220871,1.3548405276
2020-06-14,308,118525,,,,,,,230508,161193,317181,2549178,1735069,3545147,19728548,14185794,26327432,1.20549908326,1.05074966819,1.35426145543
2020-06-15,394,118919,,,,,,,242060,169561,331742,2665491,1822326,3698869,19970608,14355355,26659174,1.20520933937,1.04849075494,1.35326825631
2020-06-16,838,119757,,,,,,,254037,178843,347696,2789620,1915749,3863030,20224645,14534198,27006870,1.20393898348,1.03930653579,1.35230243103
2020-06-17,744,120501,,,,,,,266361,188275,362982,2921468,2015291,4036115,20491006,14722473,27369852,1.20169320505,1.031025124,1.35073043637
2020-06-18,718,121219,,,,,,,278939,197863,378395,3060831,2120558,4217891,20769945,14920336,27748247,1.19849390981,1.02443455189,1.34997025127
2020-06-19,670,121889,,,,,,,291663,207752,394002,3207372,2231543,4408061,21061608,15128088,28142249,1.1943572032,1.0157893414,1.35027731089
2020-06-20,604,122493,,,,,,,304414,218187,408931,3360619,2348383,4605387,21366022,15346275,28551180,1.18931126841,1.00642154148,1.3528444601
2020-06-21,285,122778,,,,,,,317062,228633,423718,3519949,2470752,4809208,21683084,15574908,28974898,1.18338308607,0.997434211368,1.35314500737
2020-06-22,389,123167,,,,,,,329472,239088,438022,3684584,2598135,5018234,22012556,15813996,29412920,1.17666767852,0.989053618136,1.35335784623
2020-06-23,847,124014,,,,,,,341510,249021,452258,3853595,2729604,5231022,22354066,16063017,29865178,1.16928245999,0.983726441631,1.35302156302
2020-06-24,759,124773,,,,,,,353049,259450,465690,4025913,2865279,5446473,22707115,16322467,30330868,1.16136527871,0.977705097536,1.35297730906
2020-06-25,551,125324,,,,,,,363980,268584,478940,4200349,3003246,5663384,23071095,16591051,30809808,1.15306302531,0.973400094165,1.35302413775
2020-06-26,617,125941,,,,,,,374213,277528,490031,4375624,3143024,5878823,23445308,16868579,31299839,1.14448820643,0.968850329308,1.35156992208
2020-06-27,504,126445,,,,,,,383684,286145,500242,4550398,3283848,6090322,23828992,17154724,31800081,1.13576736435,0.966254785256,1.35172827868
2020-06-28,273,126718,,,,,,,392351,294328,509153,4723305,3424915,6296894,24221343,17449052,32309234,1.12699611707,0.960906822687,1.35041753014
2020-06-29,377,127095,,,,,,,400189,301510,517466,4892986,3565263,6497144,24621532,17750562,32826700,1.11826583135,0.956986106367,1.34925234145
2020-06-30,625,127720,,,,,,,407191,307857,525059,5058117,3703629,6690522,25028723,18058419,33351759,1.10964132211,0.953994978323,1.3481423312
2020-07-01,694,128414,,,,,,,413358,313119,531778,5217437,3837978,6874729,25442081,18371538,33883537,1.10114248351,0.949766463213,1.34509351491
2020-07-02,727,129141,,,,,,,418705,318024,538216,5369781,3967808,7050119,25860786,18689562,34421753,1.09277280264,0.94824049693,1.34058808243
2020-07-03,660,129801,,,,,,,423258,322466,543198,5514100,4092501,7215102,26284044,19012028,34964951,1.08450347389,0.947039861371,1.33471249958
2020-07-04,265,130066,,,,,,,427051,325682,546425,5649488,4210508,7367692,26711095,19337710,35511376,1.07631614407,0.945035323973,1.32610997468
2020-07-05,288,130354,,,,,,,430125,328884,550420,5775199,4321246,7509299,27141220,19666594,36061796,1.06820514414,0.941325815782,1.31442507972
2020-07-06,355,130709,,,,,,,432521,331566,552761,5890659,4424206,7638401,27573741,19998160,36614557,1.06018574351,0.93740412555,1.30243199424
2020-07-07,1222,131931,,,,,,,434280,333044,554356,5995467,4518155,7754737,28008021,20331204,37168913,1.05229001405,0.932035429098,1.29138363585
2020-07-08,863,132794,,,,,,,435438,334441,555526,6089395,4603547,7857965,28443459,20665645,37724439,1.04456389926,0.929412539504,1.2850785298
2020-07-09,1003,133797,,,,,,,436032,335582,555853,6172378,4679656,7948041,28879491,21001227,38280292,1.03706008832,0.927742924212,1.27806304269
2020-07-10,824,134621,,,,,,,436094,336272,555778,6244492,4747307,8024808,29315585,21337499,38836070,1.02983138903,0.92599044446,1.26988518409
2020-07-11,690,135311,,,,,,,435658,336610,555049,6305936,4806362,8089755,29751243,21674109,39391119,1.02293148315,0.923802014947,1.25698907262
2020-07-12,459,135770,,,,,,,434754,337177,553843,6357006,4857378,8143309,30185997,22011286,39944962,1.01640875986,0.92240281786,1.24760994682
2020-07-13,367,136137,,,,,,,433415,336651,551556,6398070,4899701,8185678,30619412,22347937,40496518,1.01029702916,0.920101516793,1.23420767727
2020-07-14,926,137063,,,,,,,431669,335613,549331,6429549,4933823,8217534,31051081,22683550,41045849,1.00461024056,0.916998522619,1.2147755582
2020-07-15,968,138031,,,,,,,429543,334389,546308,6451902,4960386,8238778,31480624,23017939,41592157,0.999346176485,0.915068637033,1.19986583823
2020-07-16,943,138974,,,,,,,427066,332228,543442,6465610,4979518,8250465,31907690,23350167,42135599,0.994495806243,0.913315732358,1.1857635835
2020-07-17,930,139904,,,,,,,424262,329883,540144,6471167,4991394,8252462,32331952,23680050,42675743,0.990050289334,0.91249325654,1.17019657075
2020-07-18,868,140772,,,,,,,421157,326947,535938,6469066,4995892,8245271,32753109,24006997,43211681,0.986001327565,0.90931228026,1.15558100689
2020-07-19,447,141219,,,,,,,417777,323848,531625,6459792,4994061,8230531,33170886,24330845,43743306,0.982337358779,0.907596896945,1.13643491084
2020-07-20,514,141733,,,,,,,414146,320548,527091,6443812,4985703,8207254,33585032,24651393,44270397,0.979040491742,0.90666805541,1.12794550273
2020-07-21,1107,142840,,,,,,,410288,317346,522635,6421578,4971449,8177165,33995320,24968739,44793032,0.976086369144,0.905430727184,1.10332079634
2020-07-22,1216,144056,,,,,,,406227,313666,517718,6393525,4952024,8140557,34401547,25282405,45310750,0.973445986816,0.904338092215,1.07928807512
2020-07-23,1094,145150,,,,,,,401986,309880,512902,6360073,4927402,8097970,34803533,25592285,45823652,0.971087877111,0.903132038935,1.06739907689
2020-07-24,1132,146282,,,,,,,397586,306074,508386,6321626,4897834,8050551,35201119,25898359,46332038,0.968980010813,0.901824724072,1.05613850547
2020-07-25,899,147181,,,,,,,393090,302118,503525,6278622,4863617,7998351,35594209,26200477,46835563,0.967091454325,0.900685102014,1.05023838512
2020-07-26,472,147653,,,,,,,388474,297973,498253,6231439,4824914,7941608,35982683,26498450,47333816,0.96539381398,0.899654147093,1.04661983532
2020-07-27,1120,148773,,,,,,,383758,293867,493453,6180443,4781536,7881283,36366441,26792317,47827269,0.963862289117,0.898991713365,1.04001340231
2020-07-28,1374,150147,,,,,,,378961,289504,488324,6125989,4734326,7818127,36745402,27081821,48315593,0.962476104031,0.898041003118,1.03670369482
2020-07-29,1432,151579,,,,,,,374103,285190,482979,6068424,4683846,7751874,37119505,27367011,48798572,0.961218232545,0.89704349533,1.03342153715
2020-07-30,1209,152788,,,,,,,369203,280943,477875,6008084,4630348,7683533,37488708,27647954,49276447,0.960074563725,0.896304576402,1.03044835127
2020-07-31,1243,154031,,,,,,,364270,276294,472467,5945288,4574373,7612648,37852978,27924248,49748914,0.959032846382,0.895656671601,1.02760355306
2020-08-01,1115,155146,,,,,,,359314,271186,466428,5880340,4515642,7539019,38212292,28195434,50215342,0.958081781972,0.895039503629,1.02677968792
2020-08-02,403,155549,,,,,,,354345,266802,460839,5813528,4455471,7463983,38566637,28462236,50676181,0.957210498931,0.894448414551,1.0252912957
2020-08-03,530,156079,,,,,,,349373,261805,455038,5745124,4393402,7387449,38916010,28724041,51131219,0.956408434873,0.893879820058,1.02473482436
2020-08-04,1378,157457,,,,,,,344407,256932,449629,5675385,4329766,7310031,39260417,28980973,51580848,0.955665498476,0.893082197103,1.0240933955
2020-08-05,1376,158833,,,,,,,339454,252281,444130,5604551,4264684,7231560,39599871,29233254,52024978,0.954972336156,0.891979343696,1.02350997488
2020-08-06,1253,160086,,,,,,,334521,247507,439315,5532845,4198509,7153175,39934392,29480761,52464293,0.954320567079,0.890988818589,1.02292519473
2020-08-07,1242,161328,,,,,,,329612,242832,433709,5460471,4131453,7073985,40264004,29723593,52898002,0.95370291903,0.889855493989,1.02233891031
2020-08-08,1077,162405,,,,,,,324732,238256,428874,5387617,4063631,6994476,40588736,29961849,53326876,0.953113255725,0.889110310698,1.02175073831
2020-08-09,511,162916,,,,,,,320168,233708,424290,5314696,3995222,6915241,40908904,30195557,53751166,0.952546518337,0.888110921538,1.02095626341
2020-08-10,527,163443,,,,,,,315631,229205,419753,5241853,3926460,6836745,41224535,30424762,54170919,0.951998613792,0.887122386578,1.02041823639
2020-08-11,1064,164507,,,,,,,311138,224905,415093,5169233,3857504,6758391,41535673,30649667,54586012,0.951466279066,0.886639703336,1.01986432026
2020-08-12,1505,166012,,,,,,,306702,220545,410465,5096974,3788551,6680538,41842375,30870212,54996477,0.950946942529,0.886251358187,1.01925317736
2020-08-13,1070,167082,,,,,,,302354,216485,406036,5025224,3719850,6603605,42144729,31086697,55402513,0.95043859506,0.885778741604,1.01862950592
2020-08-14,1338,168420,,,,,,,298120,212482,402017,4954141,3651389,6527750,42442849,31299179,55804530,0.949939677138,0.885244183827,1.01793048527
2020-08-15,1034,169454,,,,,,,293980,208488,397629,4883851,3583584,6452915,42736829,31507667,56202159,0.949448983802,0.884761700591,1.01746100915
2020-08-16,571,170025,,,,,,,289917,204436,393981,4814454,3516832,6380471,43026746,31712103,56596140,0.948965586872,0.884320673381,1.01681485033
2020-08-17,446,170471,,,,,,,285931,200651,390248,4746040,3450675,6309879,43312677,31912754,56986388,0.948488772563,0.883912970379,1.01623958674
2020-08-18,1325,171796,,,,,,,282023,196846,386273,4678690,3385711,6241115,43594700,32109600,57372661,0.948017992184,0.883532361425,1.01561654646
2020-08-19,1353,173149,,,,,,,278202,193142,382714,4612485,3321914,6174204,43872902,32302742,57755375,0.947552823604,0.883174068252,1.01495234992
2020-08-20,1079,174228,,,,,,,274466,189354,379397,4547497,3258979,6109480,44147368,32492096,58134772,0.947092941367,0.882834374845,1.01428584089
2020-08-21,1105,175333,,,,,,,270811,185585,375911,4483788,3197051,6046087,44418179,32677681,58510683,0.946638093667,0.88251153294,1.01361709883
2020-08-22,982,176315,,,,,,,267235,182248,372885,4421411,3136463,5985274,44685414,32859929,58883568,0.946188084673,0.882202289109,1.01296632048
2020-08-23,450,176765,,,,,,,263735,178967,369585,4360414,3077169,5925995,44949149,33038896,59253153,0.945742761028,0.881904951254,1.01228063965
2020-08-24,442,177207,,,,,,,260460,175670,366424,4300705,3019126,5868141,45209609,33214566,59619577,0.946274876117,0.882617826019,1.01287023302
2020-08-25,1239,178446,,,,,,,257259,172459,363741,4242333,2962379,5812142,45466868,33387025,59983318,0.946814320575,0.883644785822,1.01390330912
2020-08-26,1225,179671,,,,,,,254140,169388,361294,4185336,2906859,5758346,45721008,33556413,60344612,0.947360589863,0.884275394129,1.0146060078
2020-08-27,1111,180782,,,,,,,251107,166315,358493,4129741,2852627,5706370,45972115,33722728,60703105,0.947913637334,0.884243259657,1.01610300596
2020-08-28,971,181753,,,,,,,248174,163256,355523,4075561,2799396,5655840,46220289,33885984,61058628,0.948473405374,0.88384706536,1.01712740441
2020-08-29,958,182711,,,,,,,245355,160376,352981,4022796,2747289,5606777,46465644,34046360,61411609,0.949039822204,0.883042295455,1.01879457966
2020-08-30,310,183021,,,,,,,242638,157330,350935,3971454,2696133,5560053,46708282,34203690,61762544,0.949612776617,0.882396962563,1.02034847334
2020-08-31,573,183594,,,,,,,240012,154633,349093,3921549,2646331,5515137,46948294,34358323,62111637,0.950192113521,0.882985975063,1.02191139602
2020-09-01,1067,184661,,,,,,,237478,152074,347058,3873096,2597756,5471922,47185772,34510397,62458695,0.950777715349,0.883727960591,1.02351812466
2020-09-02,1056,185717,,,,,,,235035,149619,345987,3826107,2550532,5431610,47420807,34660016,62804682,0.951369493014,0.882850054282,1.02541531547
2020-09-03,1070,186787,,,,,,,232686,147168,344906,3780592,2504561,5393779,47653493,34807184,63149588,0.951967357973,0.882197310126,1.02778237294
2020-09-04,965,187752,,,,,,,230433,144725,343594,3736558,2459933,5357970,47883926,34951909,63493182,0.95257121977,0.881117561435,1.02985624637
2020-09-05,783,188535,,,,,,,228270,142267,342851,3694017,2416617,5324898,48112196,35094176,63836033,0.953180970524,0.879915750461,1.03211761412
2020-09-06,403,188938,,,,,,,226198,139945,342250,3652981,2374315,5294244,48338394,35234121,64178283,0.953796502039,0.878578980055,1.03493483935
2020-09-07,267,189205,,,,,,,224214,137742,341449,3613459,2333089,5266085,48562608,35371863,64519732,0.954417711976,0.877220232715,1.03788737972
2020-09-08,445,189650,,,,,,,222319,135455,340716,3575319,2292872,5240359,48784927,35507318,64860448,0.955044501024,0.876073481711,1.03919869737
2020-09-09,1206,190856,,,,,,,220514,133393,339794,3538574,2253805,5216398,49005441,35640711,65200242,0.95567676904,0.875283366941,1.0411051764
2020-09-10,907,191763,,,,,,,218797,131523,339237,3503231,2215938,5194324,49224238,35772234,65539479,0.956314410712,0.873646990353,1.04405518874
2020-09-11,1213,192976,,,,,,,217169,129734,339139,3469293,2179354,5174956,49441407,35901968,65878618,0.956957316897,0.8727987145,1.04576550064
2020-09-12,714,193690,,,,,,,215627,127808,339168,3436746,2143901,5158588,49657034,36029776,66217786,0.957605377313,0.871877186531,1.048184857
2020-09-13,378,194068,,,,,,,214174,125865,339307,3405564,2109383,5144899,49871208,36155641,66557093,0.958258480883,0.871314993976,1.05018865181
2020-09-14,422,194490,,,,,,,212807,123940,339440,3375734,2075990,5133393,50084015,36279581,66896533,0.958916514986,0.871322324053,1.05345429034
2020-09-15,1288,195778,,,,,,,211529,122079,339693,3347250,2043435,5123991,50295544,36401660,67236226,0.959579363973,0.86953300417,1.05672037877
2020-09-16,982,196760,,,,,,,210338,120366,340561,3320111,2011727,5117506,50505882,36522026,67576787,0.96024690872,0.867482861007,1.06026465115
2020-09-17,870,197630,,,,,,,209235,118940,341395,3294311,1981049,5112927,50715117,36640966,67918182,0.960919027038,0.865915356919,1.06459544713
2020-09-18,937,198567,,,,,,,208221,117381,342636,3269846,1951264,5110670,50923338,36758347,68260818,0.96159559394,0.86392835046,1.06875436957
2020-09-19,,,736.8999154,504,1029,199303.899915,199071,199596,207295,115708,343929,3246708,1922249,5111030,51130633,36874055,68604747,0.962276481514,0.862157617802,1.07092653046
2020-09-20,,,723.529853442,493,1015,200027.429769,199565,200611,206459,114036,345418,3224897,1894019,5113615,51337092,36988091,68950165,0.962961558437,0.860225258,1.07476193703
2020-09-21,,,710.50129063,481,1002,200737.931059,200046,201613,205712,112580,347282,3204411,1866655,5118662,51542804,37100671,69297447,0.963650689555,0.858581551163,1.07896120244
2020-09-22,,,697.814791793,469,988,201435.745851,200516,202600,205057,111202,349243,3185254,1840115,5126466,51747861,37211873,69646690,0.96434373572,0.856603206061,1.08251869644
2020-09-23,,,685.47053641,458,977,202121.216388,200974,203577,204493,109818,351958,3167427,1814479,5137714,51952354,37321691,69998648,0.965040553718,0.854746331701,1.08622417926
2020-09-24,,,673.557504146,448,966,202794.773892,201422,204543,204021,108423,354646,3150934,1789510,5152576,52156375,37430114,70353294,0.965740996116,0.85288218361,1.08957418813
2020-09-25,,,662.050176854,437,954,203456.824069,201860,205496,203643,107058,357517,3135779,1765047,5170862,52360018,37537172,70710811,0.966444911,0.851211550298,1.09242651867
2020-09-26,,,650.927783961,427,942,204107.751853,202287,206437,203360,105753,360187,3121970,1741065,5191911,52563378,37642925,71070998,0.967152141646,0.849254020895,1.09582608093
2020-09-27,,,640.17319932,417,930,204747.925052,202704,207366,203172,104579,363759,3109515,1717837,5216500,52766550,37747504,71434757,0.967862526234,0.847505756863,1.09922378868
2020-09-28,,,629.771986608,407,919,205377.697039,203112,208285,203083,103385,367416,3098424,1695357,5244606,52969633,37850889,71802173,0.968575897604,0.845683319304,1.10262013887
2020-09-29,,,619.711512731,399,910,205997.408551,203511,209194,203092,102260,371561,3088709,1673678,5276721,53172725,37953149,72173734,0.96929208299,0.843868449384,1.10608746143
2020-09-30,,,609.980696175,390,903,206607.389247,203901,210096,203203,100957,375433,3080383,1652558,5312449,53375928,38054106,72549167,0.970010903729,0.842061039543,1.10955056777
2020-10-01,,,600.569921798,381,895,207207.959169,204283,210990,203416,99852,379517,3073461,1632045,5351395,53579344,38153958,72928684,0.970740683864,0.840260982434,1.11300854601
2020-10-02,,,591.470795765,373,887,207799.429965,204657,211876,203734,98788,383962,3067959,1611896,5393955,53783078,38252746,73312646,0.97147646831,0.838588905741,1.11646043514
2020-10-03,,,585.829569614,367,884,208385.259535,205024,212759,204158,97845,389009,3063897,1592362,5440320,53987236,38350591,73701655,0.9722144986,0.837380232866,1.11990522202
2020-10-04,,,580.424388404,361,882,208965.683923,205386,213640,204692,96955,394300,3061293,1573611,5490682,54191928,38447546,74095955,0.972959284654,0.835822273991,1.12334183818
2020-10-05,,,575.254308121,355,880,209540.938231,205741,214520,205337,95920,400595,3060171,1555496,5545855,54397265,38543466,74496550,0.973709988056,0.833596916869,1.1267691565
2020-10-06,,,570.318424194,349,878,210111.256655,206091,215397,206095,95002,406931,3060554,1537918,5605495,54603360,38638468,74903481,0.974464355303,0.832359080831,1.13018598753
2020-10-07,,,565.615939301,343,876,210676.872595,206435,216272,206970,94113,414087,3062468,1520829,5670332,54810330,38732581,75317568,0.975219839127,0.830036257421,1.13359107567
2020-10-08,,,561.146200559,338,874,211238.018795,206773,217146,207965,93129,422136,3065940,1504139,5740495,55018295,38825710,75739704,0.97597695477,0.829363210917,1.13698309508
2020-10-09,,,556.908884276,333,873,211794.92768,207107,218018,209082,92236,429762,3071001,1487952,5815603,55227377,38917946,76169466,0.976744516067,0.827663091464,1.14046014147
2020-10-10,,,552.903703448,329,872,212347.831383,207437,218889,210324,91428,438253,3077682,1472322,5896334,55437701,39009374,76607719,0.977522526083,0.827233691334,1.14387560932
2020-10-11,,,549.130435945,324,873,212896.961819,207761,219760,211694,90697,447267,3086017,1457265,5983406,55649395,39100071,77054986,0.978303883252,0.827160254278,1.14727219814
2020-10-12,,,545.588960335,320,873,213442.550779,208082,220632,213197,89849,457383,3096042,1442534,6077026,55862592,39189920,77512369,0.979086412855,0.826797341043,1.15043874145
2020-10-13,,,542.279363818,314,873,213984.830143,208397,221505,214836,89092,467370,3107795,1428238,6176974,56077428,39279012,77979739,0.979872022836,0.825644121563,1.15363196272
2020-10-14,,,539.202028591,310,875,214524.032172,208707,222378,216615,88426,476763,3121318,1414404,6282170,56294043,39367438,78456502,0.980660563268,0.824789828881,1.15680429317
2020-10-15,,,536.357526055,305,876,215060.389698,209013,223253,218537,87763,487311,3136652,1401209,6394038,56512580,39455201,78943813,0.981469919259,0.823491298858,1.15995395805
2020-10-16,,,533.74660939,302,879,215594.136307,209316,224130,220607,87086,498716,3153844,1388442,6513217,56733187,39542287,79442529,0.982284809861,0.82379673758,1.16258329424
2020-10-17,,,531.370233802,298,883,216125.506541,209614,225012,222828,86442,510366,3172939,1376097,6639592,56956015,39628729,79952895,0.983100195353,0.823649504393,1.16524226146
2020-10-18,,,529.229590235,294,887,216654.736131,209909,225897,225205,85843,521491,3193985,1364097,6772061,57181220,39714572,80474386,0.983915425313,0.823079513847,1.16764367964
2020-10-19,,,527.3270057,290,892,217182.063137,210200,226788,227740,85228,533555,3217034,1352372,6911310,57408960,39799800,81007941,0.984731187123,0.822770305689,1.17010941644
2020-10-20,,,525.664481749,287,896,217707.727619,210488,227682,230439,84760,547006,3242136,1341215,7057723,57639399,39884560,81554947,0.985547438794,0.822534748429,1.17271595648
2020-10-21,,,524.243832223,283,902,218231.971451,210772,228583,233306,84232,560646,3269347,1330449,7211439,57872705,39968792,82115593,0.986366427287,0.822342433155,1.176654214
2020-10-22,,,523.067177803,280,909,218755.038629,211052,229490,236344,83753,575212,3298721,1320095,7372568,58109049,40052545,82690805,0.987202053813,0.821508296543,1.17959074669
2020-10-23,,,522.136958566,276,916,219277.175587,211329,230404,239557,83358,590749,3330313,1310330,7541185,58348606,40135903,83281554,0.988037727598,0.820606570089,1.1824820561
2020-10-24,,,521.452032397,273,923,219798.62762,211603,231325,242948,82905,606420,3364179,1301004,7717849,58591554,40218808,83887974,0.988871413529,0.819707982722,1.1853249378
2020-10-25,,,521.015934257,270,932,220319.643554,211874,232255,246521,82553,622757,3400376,1292132,7902350,58838075,40301361,84510731,0.989704670907,0.818962978896,1.18811600132
2020-10-26,,,520.832507932,267,942,220840.476062,212141,233194,250283,82177,639270,3438964,1283614,8094346,59088358,40383538,85150001,0.990537462798,0.818378845037,1.19148188782
2020-10-27,,,520.905912695,264,951,221361.381974,212406,234143,254236,81830,656475,3480003,1275598,8293432,59342594,40465368,85806476,0.991363889244,0.818195508194,1.19466828854
2020-10-28,,,521.240642825,261,963,221882.622617,212668,235103,258378,81655,675130,3523545,1268163,8501168,59600972,40547023,86481606,0.99218607941,0.817242126318,1.19795523682
2020-10-29,,,521.841578983,258,973,222404.464196,212927,236073,262718,81512,693303,3569648,1261249,8717662,59863690,40628535,87174909,0.99300671882,0.816715024318,1.20102178493
2020-10-30,,,522.713976437,256,983,222927.178173,213184,237054,267256,81258,713471,3618366,1254744,8943762,60130946,40709793,87888380,0.993825098225,0.816569990386,1.20417120457
2020-10-31,,,523.863461904,253,995,223451.041635,213438,238046,271997,81060,734122,3669756,1248719,9179090,60402943,40790853,88622502,0.9946345234,0.816446282004,1.20586462346
2020-11-01,,,525.296028309,250,1009,223976.337663,213689,239052,276941,81006,755503,3723869,1243284,9424153,60679884,40871859,89378005,0.995436979018,0.816347571292,1.20770995256
