date,actual_deaths,total_deaths,predicted_deaths_mean,predicted_deaths_lower,predicted_deaths_upper,predicted_total_deaths_mean,predicted_total_deaths_lower,predicted_total_deaths_upper,predicted_new_infected_mean,predicted_new_infected_lower,predicted_new_infected_upper,predicted_current_infected_mean,predicted_current_infected_lower,predicted_current_infected_upper,predicted_total_infected_mean,predicted_total_infected_lower,predicted_total_infected_upper,r_values_mean,r_values_lower,r_values_upper
2020-02-05,0,0,,,,,,,125,66,178,125,66,178,125,66,178,2.26377553024,2.1,2.4
2020-02-06,0,0,,,,,,,125,66,178,251,132,356,250,132,356,2.26376615169,2.09998895346,2.39999969787
2020-02-07,0,0,,,,,,,125,66,178,376,197,534,375,198,534,2.26376297704,2.09998543386,2.39999953715
2020-02-08,0,0,,,,,,,125,66,178,502,264,712,500,264,712,2.26375871577,2.0999807927,2.39999929018
2020-02-09,0,0,,,,,,,287,163,405,789,441,1102,787,427,1117,2.26375299117,2.09997467255,2.39999891123
2020-02-10,0,0,,,,,,,287,163,405,1077,610,1501,1074,590,1522,2.263745294,2.09996660205,2.39999832939
2020-02-11,0,0,,,,,,,287,163,405,1364,776,1903,1361,753,1927,2.26373493511,2.09995595961,2.39999743696
2020-02-12,0,0,,,,,,,287,163,405,1652,941,2305,1648,916,2332,2.26372098076,2.09994140051,2.39999614753
2020-02-13,0,0,,,,,,,451,272,630,2102,1231,2915,2099,1188,2962,2.26370216427,2.09992150841,2.39999424115
2020-02-14,0,0,,,,,,,661,402,921,2763,1637,3831,2760,1590,3883,2.26364710164,2.09985940586,2.39996732944
2020-02-15,0,0,,,,,,,1200,738,1613,3963,2430,5404,3960,2328,5496,2.2636090724,2.09981866333,2.39996020785
2020-02-16,0,0,,,,,,,2397,1456,3079,6360,4013,8421,6357,3784,8575,2.26355054446,2.0997571829,2.39994353102
2020-02-17,0,0,,,,,,,3896,2512,4917,10256,6660,13254,10253,6296,13492,2.26347560267,2.09967934714,2.39992325995
2020-02-18,0,0,,,,,,,4305,2820,5447,14562,9521,18674,14558,9116,18939,2.263377361,2.09957844907,2.39990042509
2020-02-19,0,0,,,,,,,5053,3372,6398,19615,12953,25025,19611,12488,25337,2.26324675647,2.09944623442,2.39986766357
2020-02-20,0,0,,,,,,,5193,3472,6589,24683,16370,31426,24804,15960,31926,2.26307067267,2.09927101118,2.39981565174
2020-02-21,0,0,,,,,,,5724,3888,7249,30281,20216,38478,30528,19848,39175,2.262831659,2.0990386855,2.39974841766
2020-02-22,0,0,,,,,,,6763,4661,8566,36919,24855,46825,37291,24509,47741,2.26250983709,2.09873103727,2.39965461569
2020-02-23,0,0,,,,,,,8011,5625,10167,44805,30492,56727,45302,30134,57908,2.26207656036,2.09832676149,2.3995144903
2020-02-24,0,0,,,,,,,10187,7150,12998,54705,37552,69259,55489,37284,70906,2.26149080199,2.09780772862,2.39932798068
2020-02-25,0,0,,,,,,,16065,10707,20471,70482,48275,89207,71554,47991,91377,2.26069617801,2.09715531301,2.39905527548
2020-02-26,0,0,,,,,,,19490,13234,24885,89685,61389,113644,91044,61225,116262,2.25961506468,2.09631575109,2.39864261955
2020-02-27,0,0,,,,,,,21237,14313,27350,110635,75554,140574,112281,75538,143612,2.25814242682,2.09522709014,2.39804719522
2020-02-28,0,0,,,,,,,25811,17236,33607,135995,92519,173544,138092,92774,177219,2.25613386019,2.0937032521,2.3972061504
2020-02-29,1,1,,,,,,,31609,20559,41839,166943,112687,214419,169701,113333,219058,2.2533902838,2.09163260896,2.39594291518
2020-03-01,0,1,,,,,,,41136,26165,55096,206879,138175,267784,210837,139498,274154,2.24963854847,2.08881681441,2.39407710405
2020-03-02,5,6,,,,,,,51217,32258,69268,255700,169085,333827,262054,171756,343422,2.24450595956,2.08508832746,2.39132706813
2020-03-03,1,7,,,,,,,63322,39660,86278,315125,206325,415043,325376,211416,429700,2.23748800312,2.07979137731,2.38727257934
2020-03-04,4,11,,,,,,,77793,48099,106991,388613,251710,516418,403169,259515,536691,2.2279080309,2.07251632193,2.38129927254
2020-03-05,1,12,,,,,,,97353,59646,134908,480913,308082,644716,500522,319161,671599,2.21487160346,2.06354760676,2.37263556842
2020-03-06,2,14,,,,,,,119386,72481,166748,595105,377197,804655,619908,391642,838347,2.19722290851,2.05126784832,2.36000001782
2020-03-07,3,17,,,,,,,144259,87752,202177,733639,461138,999390,764167,479394,1040524,2.17351810111,2.03147955114,2.34216115748
2020-03-08,4,21,,,,,,,171401,105652,238758,898278,562122,1229483,935568,585046,1279282,2.14204321773,2.0009646462,2.31509475094
2020-03-09,1,22,,,,,,,200187,126868,274658,1090454,683242,1494010,1135755,711914,1553940,2.10091840746,1.94481418426,2.27817544144
2020-03-10,6,28,,,,,,,229552,151773,310365,1309818,827619,1791515,1365307,863687,1864305,2.04833662404,1.86967465365,2.25845855513
2020-03-11,5,33,,,,,,,255718,173642,342127,1549471,990511,2113130,1621025,1037329,2206432,1.98296085915,1.78399558813,2.21782081372
2020-03-12,10,43,,,,,,,277059,188863,369729,1807040,1166003,2458013,1898084,1226192,2576161,1.90442750797,1.68923942481,2.1820162563
2020-03-13,8,51,,,,,,,293420,202972,389466,2079222,1354544,2820132,2191504,1429164,2965627,1.8137920427,1.57117780336,2.11232119978
2020-03-14,7,58,,,,,,,304572,210110,400196,2357983,1547321,3186658,2496076,1639274,3365823,1.7136944271,1.4567187491,2.04523140254
2020-03-15,12,70,,,,,,,311839,216332,410800,2638213,1743130,3555455,2807915,1855606,3776623,1.60810898411,1.33660646673,1.96635740227
2020-03-16,27,97,,,,,,,315676,221329,420669,2912753,1938486,3920787,3123591,2076935,4197292,1.50173819687,1.21921420026,1.88375234482
2020-03-17,35,132,,,,,,,316993,224743,424734,3178529,2131319,4275969,3440584,2301678,4622026,1.39925981416,1.12576557039,1.78161494337
2020-03-18,59,191,,,,,,,316684,227988,424581,3431891,2320232,4613893,3757268,2529666,5046607,1.30465368797,1.05296424665,1.66593937651
2020-03-19,73,264,,,,,,,315302,230491,421942,3669400,2503472,4928296,4072570,2760157,5468549,1.22075385933,1.00226097165,1.54509411218
2020-03-20,99,363,,,,,,,313327,232377,419850,3885374,2677322,5212464,4385897,2992534,5888399,1.14907088959,0.965926750766,1.44297651908
2020-03-21,99,462,,,,,,,310873,233361,416398,4076861,2839494,5461325,4696770,3225895,6304797,1.08985996231,0.940102585674,1.34225260491
2020-03-22,110,572,,,,,,,308030,234040,411682,4240633,2987235,5670060,5004800,3459935,6716479,1.04237369861,0.92297543143,1.25843543345
2020-03-23,189,761,,,,,,,304931,233573,405484,4374162,3116666,5836028,5309731,3693508,7121963,1.00521526435,0.903433591242,1.18794616512
2020-03-24,239,1000,,,,,,,301611,232542,397492,4475586,3223834,5958040,5611342,3926050,7519455,0.976695594744,0.883441727822,1.12612680274
2020-03-25,324,1324,,,,,,,298094,230301,390529,4544128,3303632,6037186,5909436,4156351,7909984,0.955116448303,0.871040597133,1.07239423393
2020-03-26,408,1732,,,,,,,294362,228387,384136,4582771,3359493,6078282,6203798,4384738,8294120,0.938946118008,0.861043463076,1.03495326181
2020-03-27,518,2250,,,,,,,290388,226545,377022,4596100,3397862,6084742,6494186,4611283,8671142,0.926897804584,0.854349166254,1.00546866584
2020-03-28,633,2883,,,,,,,286171,223004,369592,4588851,3418080,6064146,6780357,4834287,9040734,0.917941238818,0.849307594402,0.985220222131
2020-03-29,586,3469,,,,,,,281742,218792,361943,4566022,3426185,6025182,7062099,5053079,9402677,0.911278287536,0.845859712192,0.972340780338
2020-03-30,692,4161,,,,,,,277051,214442,354721,4531234,3423155,5968696,7339150,5267521,9757398,0.906304473442,0.843316673926,0.963131409298
2020-03-31,1085,5246,,,,,,,272147,209865,347175,4487705,3410161,5895372,7611297,5477386,10104573,0.902569000907,0.841719901454,0.957105859841
2020-04-01,1172,6418,,,,,,,267047,205066,339767,4437759,3388791,5811072,7878344,5682452,10444340,0.899739169511,0.840392627899,0.952707150982
2020-04-02,1503,7921,,,,,,,261780,200490,332731,4382855,3359720,5720189,8140124,5882942,10777071,0.897571120632,0.83954370813,0.949313218928
2020-04-03,1392,9313,,,,,,,256375,196226,326096,4323928,3324027,5625359,8396499,6079168,11103167,0.895886892161,0.838525677988,0.946601891037
2020-04-04,1523,10836,,,,,,,250858,191747,319082,4261459,3282160,5525661,8647357,6270915,11422249,0.894556943668,0.837553456331,0.944751618575
2020-04-05,1590,12426,,,,,,,245265,187225,312205,4195851,3235042,5422724,8892622,6458140,11734454,0.893487099807,0.836877265601,0.943182114494
2020-04-06,1770,14196,,,,,,,239635,182743,305542,4127456,3183076,5317940,9132257,6640883,12039996,0.892608916462,0.836470937678,0.941739637164
2020-04-07,2571,16767,,,,,,,234004,178185,298569,4056529,3127228,5212289,9366261,6819068,12338565,0.891872630333,0.835806969478,0.940928810004
2020-04-08,2146,18913,,,,,,,228406,173748,291535,3983325,3068154,5107369,9594667,6992816,12630100,0.8912420261,0.835297239705,0.940237525913
2020-04-09,2228,21141,,,,,,,222873,169445,284846,3908104,3007083,5002433,9817540,7162261,12914946,0.890690711661,0.834700052185,0.939606360168
2020-04-10,2218,23359,,,,,,,217428,164955,277760,3831171,2943501,4896638,10034968,7327216,13192706,0.890199420077,0.834253799574,0.93907668493
2020-04-11,2119,25478,,,,,,,212091,160818,271154,3752874,2877666,4791182,10247059,7488034,13463860,0.88975141748,0.833934319763,0.938593937763
2020-04-12,1816,27294,,,,,,,206875,156810,264825,3673579,2811381,4686679,10453934,7644844,13728685,0.889341306098,0.833497638257,0.9381446119
2020-04-13,1946,29240,,,,,,,201789,152728,258641,3593626,2745249,4583523,10655723,7797572,13987326,0.888957670633,0.833166486273,0.937729709777
2020-04-14,2455,31695,,,,,,,196837,148731,252694,3513411,2679494,4481560,10852560,7946303,14240020,0.88859637312,0.832871003633,0.937382127429
2020-04-15,2609,34304,,,,,,,192019,144794,247218,3433283,2614402,4381628,11044579,8091097,14487238,0.888263224579,0.832512599622,0.937017688749
2020-04-16,2176,36480,,,,,,,187334,140923,241768,3353570,2550254,4283629,11231913,8232020,14729006,0.887942944197,0.832198891359,0.936589485217
2020-04-17,2093,38573,,,,,,,182779,137199,236475,3274569,2486969,4187365,11414692,8369219,14965481,0.887639756341,0.831911951037,0.936298675705
2020-04-18,1960,40533,,,,,,,178350,133429,231465,3196544,2424187,4092722,11593042,8502648,15196946,0.887350863271,0.831645097434,0.936012852587
2020-04-19,1931,42464,,,,,,,174042,129647,226734,3119729,2362094,4000400,11767084,8632295,15423680,0.88707716115,0.831316011259,0.935748619418
2020-04-20,2186,44650,,,,,,,169850,126033,221858,3044314,2300901,3910090,11936934,8758328,15645538,0.886818776723,0.831075504892,0.935471867533
2020-04-21,2548,47198,,,,,,,165771,122595,217365,2970449,2240737,3821954,12102705,8880923,15862903,0.886575971374,0.830845633599,0.935235087315
2020-04-22,2434,49632,,,,,,,161800,119197,212843,2898245,2181735,3736300,12264505,9000120,16075746,0.886349960402,0.830639665318,0.935020246802
2020-04-23,2466,52098,,,,,,,157934,115935,208558,2827773,2123902,3653413,12422439,9116055,16284304,0.886144133782,0.830460930603,0.934742048054
2020-04-24,2154,54252,,,,,,,154171,112764,204503,2759070,2067185,3573173,12576610,9228819,16488807,0.885962779295,0.830291463131,0.934481065076
2020-04-25,1698,55950,,,,,,,150509,109623,200491,2692151,2011818,3496007,12727119,9338442,16689298,0.885811781391,0.830184753086,0.934248135606
2020-04-26,1329,57279,,,,,,,146947,106582,196455,2627007,1957541,3421406,12874066,9445024,16885753,0.885699586807,0.83009437787,0.93400241087
2020-04-27,1466,58745,,,,,,,143481,103474,192713,2563613,1904166,3349385,13017547,9548498,17078466,0.885637120427,0.829936755419,0.933813084234
2020-04-28,2241,60986,,,,,,,140113,100477,188997,2501937,1851874,3279819,13157660,9648975,17267463,0.885639302285,0.829999224774,0.933829835028
2020-04-29,2521,63507,,,,,,,136839,97544,185318,2441939,1800639,3212502,13294499,9746519,17452781,0.88572602067,0.829938402094,0.933696236033
2020-04-30,2322,65829,,,,,,,133661,94723,181775,2383581,1750529,3147103,13428160,9841242,17634556,0.885923555969,0.82992144697,0.933764733564
2020-05-01,1891,67720,,,,,,,130580,91960,178351,2326827,1701535,3083710,13558740,9933202,17812907,0.886266238161,0.829975371617,0.933993816313
2020-05-02,1692,69412,,,,,,,127596,89184,175051,2271644,1653494,3022299,13686336,10022386,17987958,0.886798367289,0.830022077465,0.934034662117
2020-05-03,1120,70532,,,,,,,124710,86598,171873,2218004,1606644,2962710,13811046,10108984,18159831,0.887575942065,0.8302391883,0.934734494984
2020-05-04,1333,71865,,,,,,,121920,84066,168801,2165882,1561050,2904775,13932966,10193050,18328632,0.888667912433,0.830403513535,0.935570612495
2020-05-05,2318,74183,,,,,,,119235,81673,165817,2115267,1516679,2848726,14052201,10274723,18494449,0.890156045546,0.830627129562,0.937141897932
2020-05-06,2364,76547,,,,,,,116655,79342,162980,2066150,1473416,2794330,14168856,10354065,18657429,0.892132348133,0.830990336,0.941795278663
2020-05-07,1934,78481,,,,,,,114182,77121,160355,2018532,1431331,2741828,14283038,10431186,18817784,0.894692903376,0.831165665648,0.954034312204
2020-05-08,1747,80228,,,,,,,111823,75030,157772,1972421,1390416,2691024,14394861,10506216,18975556,0.897927763396,0.831804078171,0.970144933353
2020-05-09,1488,81716,,,,,,,109582,73103,155336,1927833,1350746,2641840,14504443,10579319,19130892,0.901908625881,0.832186779006,0.991677899232
2020-05-10,893,82609,,,,,,,107471,71255,153036,1884794,1312372,2594370,14611914,10650574,19283928,0.906679059977,0.832870196212,1.01752199595
2020-05-11,1014,83623,,,,,,,105497,69543,150793,1843344,1275330,2548697,14717411,10720117,19434721,0.912253649487,0.833573203576,1.04892939058
2020-05-12,1627,85250,,,,,,,103671,67969,148897,1803534,1239825,2504870,14821082,10788086,19583618,0.918629025642,0.834179807594,1.07554457403
2020-05-13,1764,87014,,,,,,,102007,66505,147245,1765429,1205852,2463105,14923089,10854591,19730863,0.925801354561,0.835142754605,1.10224661004
2020-05-14,1783,88797,,,,,,,100518,65225,145672,1729108,1173531,2423444,15023607,10919816,19876535,0.933778720912,0.836226768254,1.12574553781
2020-05-15,1681,90478,,,,,,,99217,64043,144237,1694664,1142848,2385891,15122824,10983859,20020772,0.942581097763,0.838186612938,1.14665735393
2020-05-16,1216,91694,,,,,,,98119,62981,143015,1662203,1113869,2350540,15220943,11046840,20163787,0.952231831124,0.840850545085,1.16431659179
2020-05-17,758,92452,,,,,,,97237,62079,142225,1631843,1086772,2317702,15318180,11108919,20306012,0.962749075065,0.844402787046,1.17810769736
2020-05-18,1172,93624,,,,,,,96583,61397,141604,1603717,1061585,2287419,15414763,11170316,20447616,0.974137114354,0.849258608881,1.19442079771
2020-05-19,1552,95176,,,,,,,96172,60817,141147,1577968,1038354,2259750,15510935,11231133,20588763,0.986367933241,0.85584102731,1.22830456134
2020-05-20,1526,96702,,,,,,,96013,60634,141078,1554745,1017345,2235000,15606948,11291767,20729841,0.999349883707,0.86467378323,1.23937441914
2020-05-21,1217,97919,,,,,,,96116,60580,141429,1534206,998625,2213434,15703064,11352347,20871270,1.01289992144,0.874770625839,1.25295529853
2020-05-22,1244,99163,,,,,,,96489,60734,142103,1516514,982295,2195163,15799553,11413081,21013373,1.02674623064,0.875660787771,1.25717463372
2020-05-23,1109,100272,,,,,,,97144,61064,143039,1501836,968393,2180402,15896697,11474145,21156412,1.04057316815,0.875772174998,1.26556811146
2020-05-24,622,100894,,,,,,,98088,61666,144403,1490341,957021,2169430,15994785,11535811,21300815,1.05409084419,0.876028536185,1.27633890611
2020-05-25,548,101442,,,,,,,99330,62448,146129,1482200,948281,2162478,16094115,11598259,21446944,1.0670932582,0.876761012143,1.28571008657
2020-05-26,662,102104,,,,,,,100886,63573,148175,1477589,942382,2159816,16195001,11661832,21595119,1.07947671573,0.877730647143,1.29753107396
2020-05-27,1518,103622,,,,,,,102768,64834,150574,1476686,939315,2161442,16297769,11726666,21745693,1.0912173619,0.879446455848,1.30643015665
2020-05-28,1178,104800,,,,,,,104979,66447,153576,1479658,939324,2167707,16402748,11793113,21899269,1.10232978737,0.88158935796,1.3118566545
2020-05-29,1160,105960,,,,,,,107532,68251,156809,1486672,942409,2178782,16510280,11861364,22056078,1.11283512705,0.884355978393,1.3217126215
2020-05-30,963,106923,,,,,,,110439,70393,160772,1497894,948807,2195247,16620719,11931757,22216850,1.12277854007,0.887548335212,1.33245211025
2020-05-31,581,107504,,,,,,,113719,72911,165035,1513494,958781,2217200,16734438,12004668,22381885,1.13220198471,0.892017186533,1.34041966347
2020-06-01,776,108280,,,,,,,117388,75685,169817,1533645,972422,2244717,16851826,12080353,22551702,1.14116450985,0.899561816724,1.34620411099
2020-06-02,1068,109348,,,,,,,121463,78774,174873,1558524,989816,2277913,16973289,12159127,22726575,1.14968255365,0.909014068685,1.35013323234
2020-06-03,1007,110355,,,,,,,125962,82114,180508,1588315,1011114,2317192,17099251,12241241,22907083,1.15774694577,0.921627016087,1.35272273419
2020-06-04,1023,111378,,,,,,,130910,85829,187050,1623212,1036309,2363075,17230161,12327070,23094133,1.16530250067,0.931129494253,1.35523433371
2020-06-05,914,112292,,,,,,,136320,89953,194312,1663417,1065683,2415862,17366481,12417023,23288445,1.17229728922,0.93663137339,1.35563768592
2020-06-06,659,112951,,,,,,,142218,94539,202302,1709146,1099493,2475972,17508699,12511562,23490747,1.1786898037,0.941474298127,1.35429539718
2020-06-07,438,113389,,,,,,,148622,99319,211208,1760624,1137748,2544052,17657321,12610881,23701955,1.18442007708,0.948741274255,1.35304788688
2020-06-08,519,113908,,,,,,,155553,104218,220271,1818089,1180297,2619822,17812874,12715099,23922226,1.18945734224,0.957995231759,1.35432799937
2020-06-09,950,114858,,,,,,,163028,109849,230397,1881788,1227697,2704005,17975902,12824948,24152623,1.19373759229,0.968356132772,1.3547100636
2020-06-10,901,115759,,,,,,,171061,115748,240910,1951962,1279864,2796669,18146963,12940696,24393533,1.19722822271,0.984364089066,1.35429817023
2020-06-11,871,116630,,,,,,,179654,122266,252785,2028848,1337288,2898824,18326617,13062962,24646318,1.19990173432,1.00756992335,1.35437002759
2020-06-12,828,117458,,,,,,,188809,128975,265731,2112678,1399811,3010927,18515426,13191937,24912049,1.20171926366,1.03338240908,1.35287670815
2020-06-13,759,118217,,,,,,,198514,136131,278929,2203660,1467687,3133020,18713940,13328068,25190978,1.20266052228,1.05262093447,1.35264253439
2020-06-14,308,118525,,,,,,,208744,143665,292483,2301965,1540959,3264743,18922684,13471733,25483461,1.20266995758,1.04632105235,1.35282475414
2020-06-15,394,118919,,,,,,,219462,151461,306953,2407709,1619516,3406697,19142146,13623194,25790414,1.20173761335,1.04570576628,1.35282708715
2020-06-16,838,119757,,,,,,,230611,159808,322218,2520932,1703631,3559127,19372757,13783002,26112632,1.1998293648,1.03146676263,1.35212411403
2020-06-17,744,120501,,,,,,,242119,168068,336165,2641588,1792903,3720480,19614876,13951070,26448797,1.1969507849,1.02027756282,1.3499786914
2020-06-18,718,121219,,,,,,,253901,177200,350600,2769526,1887953,3890649,19868777,14128270,26799397,1.19311657169,1.01362862606,1.34868577411
2020-06-19,670,121889,,,,,,,265852,186413,365183,2904469,1988499,4068866,20134629,14314683,27164580,1.18833244318,1.00856509976,1.34956646087
2020-06-20,604,122493,,,,,,,277861,195734,379230,3046009,2094247,4253892,20412490,14510417,27543810,1.18261897721,1.00142789314,1.35103561878
2020-06-21,285,122778,,,,,,,289803,205445,394180,3193594,2205123,4445864,20702293,14715862,27937990,1.17599672592,0.991533508007,1.35205587614
2020-06-22,389,123167,,,,,,,301551,215521,408075,3346523,2321278,4642786,21003844,14931383,28346065,1.16855976948,0.985284828281,1.35208901047
2020-06-23,847,124014,,,,,,,312980,225207,421316,3503949,2442216,4843845,21316824,15156590,28767381,1.16043030479,0.981225241064,1.35218053526
2020-06-24,759,124773,,,,,,,323972,234265,433839,3664893,2566583,5047269,21640796,15390855,29201220,1.15176150812,0.973302445784,1.3509833878
2020-06-25,551,125324,,,,,,,334422,243325,446450,3828255,2694107,5252759,21975218,15634180,29647670,1.14271890818,0.968844930354,1.34949909403
2020-06-26,617,125941,,,,,,,344241,251743,457815,3992841,2823537,5457704,22319459,15885923,30105485,1.13343521849,0.963195951231,1.34890170128
2020-06-27,504,126445,,,,,,,353361,259818,468215,4157393,2954349,5660048,22672820,16145741,30573700,1.12405559006,0.95867925255,1.35086011163
2020-06-28,273,126718,,,,,,,361736,267433,477171,4320615,3085639,5858154,23034556,16413174,31050871,1.1146914585,0.952215661407,1.34875476065
2020-06-29,377,127095,,,,,,,369337,274164,485212,4481208,3216132,6050719,23403893,16687338,31536083,1.10544391835,0.947873651003,1.34665618167
2020-06-30,625,127720,,,,,,,376151,280256,492463,4637896,3344935,6236089,23780044,16967594,32028546,1.09638622436,0.945114506712,1.34500130372
2020-07-01,694,128414,,,,,,,382177,285554,498968,4789462,3470695,6412775,24162221,17253148,32527514,1.0875455298,0.942031232199,1.34212927752
2020-07-02,727,129141,,,,,,,387424,289521,505460,4934767,3592161,6582102,24549645,17542669,33032974,1.07892591931,0.937164814522,1.33281911141
2020-07-03,660,129801,,,,,,,391911,293171,510219,5072778,3708159,6741813,24941556,17835840,33543193,1.07049752958,0.932866361214,1.32429713027
2020-07-04,265,130066,,,,,,,395665,296529,514336,5202590,3818322,6891069,25337221,18132369,34057529,1.06223758541,0.928797172032,1.31696190823
2020-07-05,288,130354,,,,,,,398716,299414,517279,5323446,3922059,7029240,25735937,18431783,34574808,1.05413468373,0.926830787243,1.30970820298
2020-07-06,355,130709,,,,,,,401102,301857,519717,5434745,4018523,7154888,26137039,18733640,35094525,1.04619741832,0.923689310923,1.29776350323
2020-07-07,1222,131931,,,,,,,402860,303717,521756,5536054,4106779,7268649,26539899,19037357,35616281,1.03845091649,0.919602590015,1.2849787727
2020-07-08,863,132794,,,,,,,404028,304871,523337,5627102,4186505,7370722,26943927,19342228,36139618,1.03093421886,0.915388790751,1.27175633552
2020-07-09,1003,133797,,,,,,,404645,305739,524372,5707774,4258048,7461282,27348572,19647967,36663990,1.02369249311,0.913057763858,1.26190042269
2020-07-10,824,134621,,,,,,,404746,306235,524571,5778098,4321012,7539431,27753318,19954202,37188561,1.0167726606,0.911080322153,1.25339709406
2020-07-11,690,135311,,,,,,,404367,306472,523848,5838225,4375789,7605479,28157685,20260674,37712409,1.01022310189,0.90899678153,1.24752917259
2020-07-12,459,135770,,,,,,,403542,305688,522419,5888406,4421689,7659673,28561227,20566362,38234828,1.00408708675,0.905171049054,1.23404172307
2020-07-13,367,136137,,,,,,,402302,305082,520711,5928972,4459362,7703198,28963529,20871444,38755539,0.998392976422,0.903722350525,1.21409669385
2020-07-14,926,137063,,,,,,,400678,303983,518311,5960314,4489180,7736284,29364207,21175427,39273850,0.993148162705,0.902798111001,1.19649012853
2020-07-15,968,138031,,,,,,,398699,302879,516105,5982863,4511791,7759924,29762906,21478306,39789955,0.988341809814,0.900163635099,1.18535556215
2020-07-16,943,138974,,,,,,,396396,301404,513373,5997082,4527625,7774321,30159302,21779710,40303328,0.98395377354,0.898162488167,1.16811608078
2020-07-17,930,139904,,,,,,,393794,299666,510150,6003452,4537742,7779024,30553096,22079376,40813478,0.979962442551,0.896476150621,1.15087718741
2020-07-18,868,140772,,,,,,,390921,297391,505987,6002461,4541942,7774832,30944017,22376767,41319465,0.976347136775,0.895681004468,1.13753708546
2020-07-19,447,141219,,,,,,,387803,295341,502058,5994599,4540750,7762619,31331820,22672108,41821523,0.973086541915,0.893720364011,1.12703688566
2020-07-20,514,141733,,,,,,,384462,292942,498202,5980345,4534263,7743600,31716282,22965050,42319725,0.970156969363,0.891992234576,1.10454009704
2020-07-21,1107,142840,,,,,,,380922,290070,493517,5960165,4522447,7717454,32097204,23255120,42813242,0.967532262425,0.890772652747,1.09059755891
2020-07-22,1216,144056,,,,,,,377205,287080,489127,5934510,4505771,7684880,32474409,23542200,43302369,0.965184759113,0.889414509211,1.06919345849
2020-07-23,1094,145150,,,,,,,373331,283910,484626,5903813,4484769,7646220,32847740,23826110,43786995,0.963086309031,0.888612614458,1.0530903967
2020-07-24,1132,146282,,,,,,,369321,280807,479665,5868489,4459800,7601567,33217061,24106917,44266660,0.96120909707,0.887899585122,1.04436993205
2020-07-25,899,147181,,,,,,,365478,278065,474904,5829221,4431593,7551959,33582539,24384982,44741564,0.95952646825,0.885280249164,1.04079869921
2020-07-26,472,147653,,,,,,,361524,275147,470087,5786378,4400225,7498237,33944063,24660129,45211651,0.958013812071,0.884583501971,1.03784999619
2020-07-27,1120,148773,,,,,,,357490,272070,465232,5740326,4366560,7441066,34301553,24932199,45676883,0.956649314996,0.884026546471,1.03408431745
2020-07-28,1374,150147,,,,,,,353402,268660,459839,5691426,4330093,7380215,34654955,25200859,46136722,0.955414328873,0.882552365722,1.02993294863
2020-07-29,1432,151579,,,,,,,349300,265416,454768,5640048,4291477,7316686,35004255,25466275,46591490,0.954293229051,0.881906689313,1.0286603372
2020-07-30,1209,152788,,,,,,,345223,262240,449660,5586572,4250786,7250259,35349478,25728515,47041150,0.953272839415,0.881293379544,1.02653529387
2020-07-31,1243,154031,,,,,,,341160,258907,444883,5531336,4208241,7181798,35690638,25987422,47486033,0.952341666203,0.880696999708,1.02466591259
2020-08-01,1115,155146,,,,,,,337101,255539,439363,5474643,4164063,7111053,36027739,26242961,47925396,0.951489220718,0.880116628886,1.02377284147
2020-08-02,403,155549,,,,,,,333055,252139,433987,5416777,4118759,7039100,36360794,26495100,48359383,0.950705613767,0.879551755016,1.02243315435
2020-08-03,530,156079,,,,,,,329031,248912,429165,5358006,4072282,6966251,36689825,26744012,48788548,0.949981448618,0.87900135182,1.02135228304
2020-08-04,1378,157457,,,,,,,325045,245578,424454,5298588,4024876,6892563,37014870,26989590,49213002,0.949308798855,0.878465781805,1.02060841727
2020-08-05,1376,158833,,,,,,,321101,242334,419508,5238767,3977105,6818620,37335971,27231924,49632510,0.948678748296,0.877943969845,1.02014534515
2020-08-06,1253,160086,,,,,,,317202,238813,414846,5178764,3928801,6744410,37653173,27470737,50047356,0.94808417599,0.877435534046,1.01942951922
2020-08-07,1242,161328,,,,,,,313349,235124,410148,5118782,3879980,6669990,37966522,27705861,50457504,0.947518954498,0.876940127821,1.01889567899
2020-08-08,1077,162405,,,,,,,309548,231750,405669,5059009,3830892,6596046,38276070,27937611,50863173,0.946977944244,0.876457429945,1.01844462294
2020-08-09,511,162916,,,,,,,306013,228902,401604,4999544,3781699,6522786,38582083,28166513,51264777,0.948407936699,0.876768033201,1.01985429645
2020-08-10,527,163443,,,,,,,302536,225827,397448,4940555,3732356,6450179,38884619,28392340,51662225,0.949858043654,0.877790169837,1.02036371834
2020-08-11,1064,164507,,,,,,,299128,222628,393611,4882193,3682897,6378588,39183747,28614968,52055836,0.951324716392,0.880032281794,1.02181544344
2020-08-12,1505,166012,,,,,,,295802,219465,389872,4824593,3633692,6308647,39479549,28834433,52445708,0.952805908381,0.882279705935,1.02402942756
2020-08-13,1070,167082,,,,,,,292579,216416,385854,4767872,3584684,6239755,39772128,29050849,52831562,0.954301994052,0.884640647821,1.02605687337
2020-08-14,1338,168420,,,,,,,289482,213428,382688,4712131,3535866,6172796,40061610,29264277,53214250,0.955809640927,0.887049175728,1.02795420632
2020-08-15,1034,169454,,,,,,,286497,210274,380191,4657468,3487230,6108111,40348107,29474551,53594441,0.957327948683,0.888135736234,1.03076920001
2020-08-16,571,170025,,,,,,,283610,207421,377271,4603977,3439112,6046026,40631717,29681972,53971712,0.958856144059,0.889086046069,1.03359824006
2020-08-17,446,170471,,,,,,,280821,204610,374690,4551742,3391588,5986734,40912538,29886582,54346402,0.960393957854,0.891026785863,1.03638027411
2020-08-18,1325,171796,,,,,,,278132,201765,372284,4500843,3344444,5929862,41190670,30088347,54718686,0.961941365111,0.892952373255,1.03893634998
2020-08-19,1353,173149,,,,,,,275549,199142,370124,4451348,3298010,5875553,41466219,30287489,55088810,0.963497654822,0.895109286893,1.04140222792
2020-08-20,1079,174228,,,,,,,273072,196549,367833,4403319,3252226,5823894,41739291,30484038,55456643,0.965062410024,0.896936146336,1.04397173319
2020-08-21,1105,175333,,,,,,,270698,193866,365715,4356815,3207282,5774778,42009989,30677904,55822358,0.96663561426,0.898951483137,1.04692978067
2020-08-22,982,176315,,,,,,,268423,191300,363957,4311889,3163460,5728600,42278412,30869204,56186315,0.968217395879,0.900142389976,1.04988501388
2020-08-23,450,176765,,,,,,,266247,188903,362232,4268588,3120616,5685173,42544659,31058107,56548547,0.969808077552,0.900447338328,1.05243086135
2020-08-24,442,177207,,,,,,,264170,186313,360547,4226745,3078026,5644124,42808829,31244420,56909094,0.97140775537,0.901129208357,1.05519708935
2020-08-25,1239,178446,,,,,,,262193,183714,359366,4186403,3035916,5606046,43071022,31428134,57268460,0.973016587024,0.9019554478,1.05765351693
2020-08-26,1225,179671,,,,,,,260316,181464,358537,4147590,2994756,5570979,43331338,31609598,57626997,0.974634967981,0.902203221049,1.06068979061
2020-08-27,1111,180782,,,,,,,258536,179245,357746,4110324,2954539,5538860,43589874,31788843,57984743,0.976263507356,0.902093268844,1.06370826791
2020-08-28,971,181753,,,,,,,256853,177025,357248,4074599,2915151,5510264,43846727,31965868,58341991,0.977902988397,0.901936403062,1.06708237639
2020-08-29,958,182711,,,,,,,255268,174794,356362,4040384,2876520,5483947,44101995,32140662,58698353,0.979554236178,0.901790073316,1.07008515888
2020-08-30,310,183021,,,,,,,253779,172827,356116,4007667,2839075,5459872,44355774,32313489,59054469,0.981218181423,0.901654789901,1.07365136744
2020-08-31,573,183594,,,,,,,252388,170862,355610,3976445,2802519,5438203,44608162,32484351,59410079,0.982895985738,0.901543685564,1.07650503697
2020-09-01,1067,184661,,,,,,,251094,168818,355317,3946718,2766735,5418818,44859256,32653169,59765396,0.984589065254,0.901670378301,1.07888320808
2020-09-02,1056,185717,,,,,,,249898,166747,355493,3918484,2731724,5402005,45109154,32819916,60120889,0.986299057904,0.902195518058,1.08211426542
2020-09-03,1070,186787,,,,,,,248799,164874,355928,3891733,2697465,5387782,45357953,32984790,60476817,0.988027731185,0.902439692494,1.08541857884
2020-09-04,965,187752,,,,,,,247798,163097,356720,3866459,2664023,5376633,45605751,33147887,60833537,0.98977692382,0.90251737828,1.08826684167
2020-09-05,783,188535,,,,,,,246896,161233,357484,3842657,2631404,5368370,45852647,33309120,61191021,0.99154849082,0.90318006313,1.09170787618
2020-09-06,403,188938,,,,,,,246093,159411,358646,3820328,2599525,5363026,46098740,33468531,61549667,0.993344164557,0.903075780618,1.09485335286
2020-09-07,267,189205,,,,,,,245391,157692,360222,3799472,2568320,5360986,46344131,33626223,61909889,0.995165323506,0.903343630337,1.09850383865
2020-09-08,445,189650,,,,,,,244789,156165,361924,3780091,2538178,5362336,46588920,33782388,62271813,0.997012707751,0.903369973102,1.10185024471
2020-09-09,1193,190843,,,,,,,244288,154632,363671,3762186,2509106,5366621,46833208,33937020,62635484,0.998886178338,0.903634204331,1.10581406186
2020-09-10,920,191763,,,,,,,243890,153263,366065,3745761,2480912,5374140,47077098,34090283,63001549,1.00078459944,0.904141236413,1.10968725241
2020-09-11,1213,192976,,,,,,,243596,151700,368411,3730821,2453369,5384796,47320694,34241983,63369960,1.00270586934,0.904286578785,1.11335338346
2020-09-12,714,193690,,,,,,,243406,150466,371360,3717373,2426812,5398908,47564100,34392449,63741320,1.004647092,0.904139003425,1.1174488215
2020-09-13,378,194068,,,,,,,243322,149232,374592,3705428,2401248,5417140,47807422,34541681,64115912,1.00660484525,0.90465139104,1.12164720727
2020-09-14,422,194490,,,,,,,243345,147962,377482,3694994,2376380,5438514,48050767,34689643,64493394,1.00857548747,0.904997713472,1.12563191379
2020-09-15,1288,195778,,,,,,,243477,146811,380369,3686083,2352326,5463282,48294244,34836454,64873763,1.01055544449,0.905472322687,1.13004363602
2020-09-16,983,196761,,,,,,,243719,145640,383439,3678707,2329148,5491414,48537963,34982094,65257202,1.01254143135,0.905450104943,1.13450566782
2020-09-17,870,197631,,,,,,,244073,144444,387545,3672882,2306844,5523469,48782036,35126538,65644747,1.01453058782,0.905299104939,1.13919833652
2020-09-18,936,198567,,,,,,,244540,143449,391964,3668623,2285422,5559498,49026576,35269987,66036711,1.01652052743,0.905448227199,1.14356446539
2020-09-19,712,199279,,,,,,,245124,142555,396409,3665949,2264883,5599171,49271700,35412542,66433120,1.01850931582,0.905420496878,1.14680141243
2020-09-20,227,199506,,,,,,,245825,141394,401014,3664878,2245051,5642689,49517525,35553936,66834134,1.02049540543,0.905403099159,1.15001214674
2020-09-21,356,199862,,,,,,,246646,140367,406238,3665431,2226014,5690267,49764171,35694303,67240372,1.02247755545,0.905095394446,1.15316000783
2020-09-22,921,200783,,,,,,,247590,139536,411439,3667631,2207864,5741468,50011761,35833839,67651811,1.02445475783,0.90507075512,1.15706834853
2020-09-23,1098,201881,,,,,,,248660,138749,417261,3671501,2190451,5796797,50260421,35972588,68069072,1.02642617704,0.905006946405,1.16094556242
2020-09-24,914,202795,,,,,,,249856,137972,423875,3677069,2173799,5856995,50510277,36110560,68492947,1.02839110256,0.904960736183,1.16478915403
2020-09-25,952,203747,,,,,,,251183,137242,430862,3684362,2157783,5921784,50761460,36247802,68923809,1.03034891082,0.904911200748,1.16859653315
2020-09-26,740,204487,,,,,,,252643,136574,437591,3693410,2142659,5990958,51014103,36384376,69361400,1.03229903467,0.904858266269,1.17236498974
2020-09-27,266,204753,,,,,,,254240,135920,444584,3704243,2128117,6064184,51268343,36520296,69805984,1.03424093994,0.905199394637,1.1761246158
2020-09-28,316,205069,,,,,,,255975,135235,451677,3716897,2114125,6141271,51524318,36655531,70257661,1.0361741082,0.904149302416,1.18060877033
2020-09-29,914,205983,,,,,,,257853,134570,459471,3731405,2100735,6223260,51782171,36790101,70717132,1.03809802433,0.904120968506,1.18531976772
2020-09-30,946,206929,,,,,,,259877,133901,467592,3747805,2087825,6310484,52042048,36924002,71184724,1.04001216709,0.904092436189,1.18868556238
2020-10-01,858,207787,,,,,,,262051,133327,476240,3766137,2075514,6403282,52304099,37057329,71660964,1.04191600163,0.903838461075,1.1926731757
2020-10-02,907,208694,,,,,,,264377,132836,485640,3786442,2063909,6501377,52568476,37190165,72146604,1.0438089733,0.90415740614,1.19690071945
2020-10-03,687,209381,,,,,,,266861,132404,495330,3808763,2052869,6604739,52835337,37322569,72641934,1.04569050261,0.903888943526,1.20158212334
2020-10-04,410,209791,,,,,,,269506,132003,505524,3833145,2042318,6713850,53104843,37454572,73147458,1.04755998111,0.903350961479,1.20541366356
2020-10-05,,,717.633615984,460,1061,210508.633616,210251,210852,272317,131667,516892,3859637,2032595,6829730,53377160,37586239,73664350,1.04941676791,0.903901880092,1.20858872987
2020-10-06,,,716.903994156,456,1068,211225.53761,210707,211920,275298,131339,528324,3888288,2023575,6951813,53652458,37717578,74192674,1.05126018645,0.903928479893,1.21167086834
2020-10-07,,,716.465916995,451,1075,211942.003527,211159,212995,278454,130897,540234,3919152,2014944,7080600,53930912,37848475,74732908,1.05308952145,0.903954337269,1.21465354701
2020-10-08,,,716.324327012,448,1084,212658.327854,211607,214078,281789,130548,552838,3952282,2006747,7216157,54212701,37979023,75285746,1.05490401593,0.903979446727,1.21752982705
2020-10-09,,,716.484671515,444,1094,213374.812526,212052,215172,285309,130354,565989,3987734,1999132,7358241,54498010,38109377,75851735,1.05669766592,0.904003800695,1.22038886169
2020-10-10,,,716.952693204,440,1104,214091.765219,212492,216276,289016,130263,580921,4025566,1992158,7508278,54787026,38239640,76432656,1.05846550897,0.904027405302,1.22268762791
2020-10-11,,,717.734439945,436,1116,214809.499659,212928,217391,292913,130182,595537,4065836,1985771,7666201,55079939,38369822,77028193,1.06021532805,0.904050258496,1.22499671397
2020-10-12,,,718.836280041,433,1128,215528.335939,213362,218518,297008,130050,610936,4108605,1979904,7832528,55376947,38499872,77639129,1.06192996151,0.904072359796,1.22716636474
2020-10-13,,,720.26493179,430,1139,216248.600871,213792,219657,301303,130018,626571,4153933,1974693,8007399,55678250,38629890,78265700,1.06361185618,0.904093709939,1.22963988438
2020-10-14,,,722.027529102,427,1150,216970.6284,214220,220807,305801,130074,643398,4201881,1970201,8191298,55984051,38759964,78909098,1.06524688191,0.901362027848,1.23239103722
2020-10-15,,,724.131620458,424,1163,217694.76002,214644,221969,310506,130184,660819,4252509,1966485,8384494,56294557,38890148,79569917,1.06682604241,0.90120792196,1.23519535935
2020-10-16,,,726.585166878,422,1180,218421.345187,215067,223149,315420,130405,679197,4305879,1963562,8587412,56609977,39020553,80249114,1.06836798179,0.901051645215,1.23837878119
2020-10-17,,,729.396550438,419,1195,219150.741738,215486,224343,320549,130532,698274,4362050,1961255,8800011,56930526,39151085,80947388,1.06985415111,0.900893259618,1.23987708706
2020-10-18,,,732.57458325,417,1212,219883.316321,215904,225554,325893,130700,717597,4421083,1959551,9022249,57256419,39281785,81664985,1.07129390289,0.900732806303,1.23703834896
2020-10-19,,,735.807445077,415,1229,220619.123766,216319,226782,331456,130892,738296,4483033,1958437,9255002,57587875,39412677,82403281,1.07267736377,0.900570344424,1.23741552687
2020-10-20,,,739.425936312,412,1247,221358.549702,216732,228028,337240,131167,760571,4547956,1957934,9498664,57925115,39543844,83163852,1.07396199489,0.900405930321,1.23591142329
2020-10-21,,,743.439441009,410,1267,222101.989143,217142,229294,343245,131526,782976,4615903,1958122,9753299,58268360,39675370,83946828,1.07517134447,0.900239619445,1.23596604356
2020-10-22,,,747.857841127,408,1288,222849.846984,217551,230581,349474,131958,804218,4686923,1959184,10017255,58617834,39807328,84751046,1.07629904058,0.900071466372,1.23468674974
2020-10-23,,,752.691526322,406,1311,223602.538511,217958,231892,355925,132370,826907,4761059,1961006,10291279,58973759,39939698,85577953,1.07735472112,0.899901526168,1.23572500277
2020-10-24,,,757.951413481,405,1331,224360.489924,218363,233222,362600,132794,849840,4838350,1963444,10575072,59336359,40072492,86427793,1.07832796412,0.899729492563,1.23415719823
2020-10-25,,,763.648954263,403,1353,225124.138878,218767,234574,369500,133341,872967,4918834,1966520,10867064,59705859,40205833,87300760,1.07923134031,0.899556115297,1.23256058366
2020-10-26,,,769.796138361,402,1377,225893.935017,219169,235950,376619,133841,897038,5002540,1970182,11168500,60082478,40339674,88197798,1.08006959586,0.899381125763,1.23127716962
2020-10-27,,,776.405457346,400,1404,226670.340474,219570,237353,383961,134513,921647,5089493,1974651,11479144,60466439,40474187,89119445,1.08085916753,0.899204587909,1.22977638528
2020-10-28,,,783.489894575,399,1431,227453.830369,219969,238783,391520,135168,946538,5179710,1979809,11799039,60857959,40609355,90065983,1.08159546503,0.899026570654,1.22869245001
2020-10-29,,,791.062893482,397,1460,228244.893262,220368,240242,399293,135829,971566,5273202,1985574,12127110,61257252,40745184,91037549,1.08226725062,0.898847149904,1.22728769746
2020-10-30,,,799.138330205,396,1490,229044.031592,220765,241731,407276,136495,997734,5369972,1991893,12463896,61664528,40881679,92035283,1.08286780136,0.898665804257,1.22555902466
2020-10-31,,,807.730498255,395,1523,229851.762091,221161,243253,415464,137193,1025881,5470015,1998687,12810435,62079992,41018872,93061164,1.08338300332,0.898483817771,1.22442979795
2020-11-01,,,816.854054338,394,1559,230668.616145,221556,244811,423852,137939,1052528,5573318,2006100,13164547,62503844,41156811,94113692,1.08383384095,0.898300730104,1.22313041997
