date,actual_deaths,total_deaths,predicted_deaths_mean,predicted_deaths_lower,predicted_deaths_upper,predicted_total_deaths_mean,predicted_total_deaths_lower,predicted_total_deaths_upper,predicted_new_infected_mean,predicted_new_infected_lower,predicted_new_infected_upper,predicted_current_infected_mean,predicted_current_infected_lower,predicted_current_infected_upper,predicted_total_infected_mean,predicted_total_infected_lower,predicted_total_infected_upper,r_values_mean,r_values_lower,r_values_upper
2020-02-05,0,0,,,,,,,125,66,178,125,66,178,125,66,178,2.26199515829,2.1,2.4
2020-02-06,0,0,,,,,,,125,66,178,250,132,356,250,132,356,2.26198534948,2.09998877688,2.39999969861
2020-02-07,0,0,,,,,,,125,66,178,375,198,534,375,198,534,2.26198204476,2.09998489492,2.39999953804
2020-02-08,0,0,,,,,,,125,66,178,499,264,712,500,264,712,2.26197761431,2.09997945576,2.39999929111
2020-02-09,0,0,,,,,,,286,162,404,785,440,1102,786,426,1116,2.26197166975,2.09997261576,2.3999989125
2020-02-10,0,0,,,,,,,286,162,404,1072,608,1501,1072,588,1520,2.26196368677,2.09996349842,2.39999833305
2020-02-11,0,0,,,,,,,286,162,404,1358,774,1902,1358,750,1924,2.26195295671,2.09995134553,2.39999750076
2020-02-12,0,0,,,,,,,286,162,404,1644,938,2304,1644,912,2328,2.2619385207,2.09993515812,2.39999626277
2020-02-13,0,0,,,,,,,449,271,630,2093,1227,2914,2093,1183,2958,2.26191907971,2.09991353797,2.39999441156
2020-02-14,0,0,,,,,,,657,401,921,2750,1633,3830,2750,1584,3879,2.26186346089,2.0998584285,2.39996799419
2020-02-15,0,0,,,,,,,1196,737,1612,3946,2425,5403,3946,2321,5491,2.26182441675,2.09981791497,2.39996128876
2020-02-16,0,0,,,,,,,2388,1453,3077,6334,4004,8416,6334,3774,8568,2.26176464819,2.09975007139,2.39994531778
2020-02-17,0,0,,,,,,,3884,2507,4912,10218,6643,13241,10218,6281,13480,2.26168807364,2.09966395249,2.39992671565
2020-02-18,0,0,,,,,,,4289,2817,5442,14507,9500,18655,14507,9098,18922,2.26158770796,2.09955859137,2.39990325182
2020-02-19,0,0,,,,,,,5033,3367,6387,19541,12927,24996,19540,12465,25309,2.26145436107,2.09941081259,2.39987197768
2020-02-20,0,0,,,,,,,5172,3466,6581,24587,16337,31389,24712,15931,31890,2.2612747669,2.09923088386,2.39982791856
2020-02-21,0,0,,,,,,,5697,3876,7237,30160,20170,38427,30409,19807,39127,2.26103128775,2.09900292296,2.39976207887
2020-02-22,0,0,,,,,,,6731,4645,8547,36766,24795,46755,37140,24452,47674,2.26070377857,2.09870766275,2.39966950535
2020-02-23,0,0,,,,,,,7977,5610,10146,44618,30416,56636,45117,30062,57820,2.26026328667,2.09831402513,2.39954392343
2020-02-24,0,0,,,,,,,10149,7124,12975,54481,37451,69146,55266,37186,70795,2.25966844533,2.09777270852,2.39935775872
2020-02-25,0,0,,,,,,,16004,10677,20413,70199,48144,89038,71270,47863,91208,2.25886249149,2.09706049175,2.39908794859
2020-02-26,0,0,,,,,,,19416,13196,24833,89329,61222,113426,90686,61059,116041,2.25776740468,2.09611933447,2.39870165846
2020-02-27,0,0,,,,,,,21153,14253,27281,110196,75329,140288,111839,75312,143322,2.25627776059,2.09486749822,2.3981356091
2020-02-28,0,0,,,,,,,25712,17177,33576,135459,92235,173224,137551,92489,176898,2.25424886984,2.09320756391,2.39730584976
2020-02-29,1,1,,,,,,,31487,20481,41780,166288,112327,214041,169038,112970,218678,2.25148162267,2.09100965524,2.39612170093
2020-03-01,0,1,,,,,,,40975,26088,55007,206068,137740,267318,210013,139058,273685,2.24770333645,2.08810064562,2.39437322459
2020-03-02,5,6,,,,,,,51021,32084,69102,254701,168474,333188,261034,171142,342787,2.24254266217,2.08415907598,2.39173936877
2020-03-03,1,7,,,,,,,63091,39497,86081,313908,205555,414208,324125,210639,428868,2.23549790063,2.07885021842,2.38783628604
2020-03-04,4,11,,,,,,,77524,47948,106864,387143,250781,515453,401649,258587,535732,2.22589757044,2.07197126969,2.3820556974
2020-03-05,1,12,,,,,,,97033,59381,135190,479142,306895,644042,498682,317968,670922,2.21285597534,2.0621948098,2.37348413752
2020-03-06,2,14,,,,,,,119010,72100,167671,592981,375637,804870,617692,390068,838593,2.19523115117,2.04757523478,2.36094906179
2020-03-07,3,17,,,,,,,143839,87306,202976,731123,459140,1000404,761531,477374,1041569,2.17159978948,2.02802663681,2.34264072945
2020-03-08,4,21,,,,,,,170950,105045,239518,895342,559531,1231268,932481,582419,1281087,2.14027608043,1.99379067617,2.31612823735
2020-03-09,1,22,,,,,,,199721,126437,274797,1087086,680229,1495954,1132202,708856,1555884,2.09941479407,1.93749304203,2.28083790987
2020-03-10,6,28,,,,,,,229072,151537,310000,1306009,824396,1793123,1361274,860393,1865884,2.04724461222,1.86676439779,2.25879650135
2020-03-11,5,33,,,,,,,255229,172759,341598,1545234,986437,2114272,1616503,1033152,2207482,1.98245389016,1.78272948361,2.21923510423
2020-03-12,10,43,,,,,,,276542,188244,369160,1802359,1161346,2458653,1893045,1221396,2576642,1.90467710112,1.68332937807,2.18166477951
2020-03-13,8,51,,,,,,,292870,202515,388503,2074077,1349488,2819890,2185915,1423911,2965145,1.81492395696,1.57116830123,2.11242627706
2020-03-14,7,58,,,,,,,303993,209731,399492,2352358,1541951,3185759,2489908,1633642,3364637,1.71573915805,1.45666831264,2.04693051966
2020-03-15,12,70,,,,,,,311243,216404,410206,2632114,1737918,3554041,2801151,1850046,3774843,1.61096695277,1.33796466498,1.97759672489
2020-03-16,27,97,,,,,,,315069,221216,419420,2906207,1933246,3918235,3116220,2071262,4194263,1.50518021797,1.21974330652,1.89280386584
2020-03-17,35,132,,,,,,,316374,224617,423453,3171560,2126127,4272282,3432594,2295879,4617716,1.4029700598,1.12729839407,1.78485699398
2020-03-18,59,191,,,,,,,316049,227697,423543,3424518,2314926,4609386,3748643,2523576,5041259,1.30830083392,1.05628347705,1.66630849556
2020-03-19,73,264,,,,,,,314644,229889,420437,3661638,2497688,4922402,4063287,2753465,5461696,1.22406130048,1.00327778661,1.54518410274
2020-03-20,99,363,,,,,,,312644,231719,418160,3877250,2671140,5204616,4375931,2985184,5879856,1.15185989827,0.968116143387,1.44297313399
2020-03-21,99,462,,,,,,,310164,233193,415698,4068403,2833551,5451894,4686095,3218377,6295554,1.09205643494,0.940517211207,1.34217088112
2020-03-22,110,572,,,,,,,307296,234138,410766,4231860,2981905,5658974,4993391,3452515,6706320,1.04398686913,0.923372528856,1.26032575614
2020-03-23,189,761,,,,,,,304175,233922,403806,4365085,3112404,5822571,5297566,3686437,7110126,1.00630528048,0.904890316781,1.18809250123
2020-03-24,239,1000,,,,,,,300842,232916,395642,4466206,3220500,5942635,5598408,3919353,7505768,0.97734428112,0.88415721877,1.12716150927
2020-03-25,324,1324,,,,,,,297325,229584,388521,4534458,3299752,6020172,5895733,4148937,7894289,0.955407634852,0.871514450294,1.07275756915
2020-03-26,408,1732,,,,,,,293606,227698,382116,4572836,3355686,6059779,6189339,4376635,8276405,0.938955353358,0.861499761153,1.03526850679
2020-03-27,518,2250,,,,,,,289660,226087,375221,4585954,3394082,6064988,6478999,4602722,8651626,0.926688558193,0.854375118197,1.00608896928
2020-03-28,633,2883,,,,,,,285484,222620,368575,4578568,3414264,6044384,6764483,4825342,9020201,0.917564681219,0.849712556393,0.985948141005
2020-03-29,586,3469,,,,,,,281108,218574,360622,4555684,3422463,6004795,7045591,5043916,9380823,0.910774660613,0.845981619262,0.972332086661
2020-03-30,692,4161,,,,,,,276478,213997,353365,4520919,3418912,5947583,7322069,5257913,9734188,0.905704946933,0.84336375416,0.963198007433
2020-03-31,1085,5246,,,,,,,271640,209606,345968,4477490,3405782,5874248,7593709,5467519,10080156,0.90189749326,0.841939217462,0.957141817736
2020-04-01,1172,6418,,,,,,,266612,204873,338989,4427727,3384323,5790321,7860321,5672392,10419145,0.89901393028,0.840714383501,0.952729584169
2020-04-02,1503,7921,,,,,,,261417,200469,331762,4373095,3355524,5699429,8121738,5872861,10750907,0.896806026042,0.839632887772,0.949338024464
2020-04-03,1392,9313,,,,,,,256084,196192,325255,4314535,3320391,5605169,8377822,6069053,11076162,0.895092471571,0.838594890322,0.946590629224
2020-04-04,1523,10836,,,,,,,250639,191681,318413,4252530,3279117,5506420,8628461,6260734,11394575,0.893741177446,0.837822012086,0.944665547872
2020-04-05,1590,12426,,,,,,,245115,187299,311641,4187481,3232286,5403605,8873576,6448033,11706216,0.892656032525,0.837147639806,0.943194291963
2020-04-06,1770,14196,,,,,,,239550,182760,304874,4119735,3180288,5299060,9113126,6630793,12011090,0.891767124922,0.836513187371,0.941774395881
2020-04-07,2571,16767,,,,,,,233979,178246,298070,4049540,3124216,5194567,9347105,6809039,12309160,0.891023579265,0.835864711966,0.940935502446
2020-04-08,2146,18913,,,,,,,228438,173871,291380,3977135,3064928,5091322,9575543,6982910,12600540,0.890388337808,0.835353153497,0.940351405645
2020-04-09,2228,21141,,,,,,,222955,169484,284527,3902766,3004597,4988107,9798498,7152394,12885067,0.889834370159,0.834881053324,0.939658036917
2020-04-10,2218,23359,,,,,,,217556,165214,278037,3826715,2941947,4884644,10016054,7317608,13163104,0.889341925548,0.834406917356,0.939163114098
2020-04-11,2119,25478,,,,,,,212259,160966,271363,3749314,2876703,4781233,10228313,7478574,13434467,0.888893910487,0.834007930048,0.938689162861
2020-04-12,1816,27294,,,,,,,207079,156879,265191,3670909,2810861,4678160,10435392,7635453,13699658,0.888483093277,0.833587784917,0.93835177333
2020-04-13,1946,29240,,,,,,,202024,152923,259180,3591825,2745139,4576873,10637416,7788376,13958838,0.888100205569,0.833267408079,0.937926161491
2020-04-14,2455,31695,,,,,,,197099,148802,253294,3512446,2679896,4476875,10834515,7937178,14212132,0.887740468166,0.832928367384,0.937574591747
2020-04-15,2609,34304,,,,,,,192304,144661,247659,3433110,2614932,4378582,11026819,8081839,14459791,0.887408677588,0.832588537096,0.937213234795
2020-04-16,2176,36480,,,,,,,187639,140874,242151,3354138,2550933,4281728,11214458,8222713,14701942,0.887091161689,0.832309557596,0.936868117131
2020-04-17,2093,38573,,,,,,,183101,137176,237011,3275822,2487648,4186965,11397559,8359889,14938953,0.886789555685,0.832063490514,0.936562750382
2020-04-18,1960,40533,,,,,,,178687,133396,231936,3198424,2424875,4093635,11576246,8493285,15170889,0.886502700977,0.831827620518,0.936290750207
2020-04-19,1931,42464,,,,,,,174391,129653,227052,3122177,2362864,4002299,11750637,8622938,15397941,0.886231134307,0.831521122223,0.936022786418
2020-04-20,2186,44650,,,,,,,170210,126063,222337,3047272,2301641,3913031,11920847,8749001,15620278,0.885974252774,0.831293429456,0.935742652139
2020-04-21,2548,47198,,,,,,,166140,122627,217661,2973862,2241512,3825862,12086987,8871628,15837939,0.88573246357,0.831081766893,0.935447195559
2020-04-22,2434,49632,,,,,,,162176,119285,213226,2902058,2182549,3741101,12249163,8990913,16051165,0.885506713239,0.830893858243,0.935170474377
2020-04-23,2466,52098,,,,,,,158316,116056,208817,2831937,2124724,3658637,12407479,9106969,16259982,0.885300153827,0.830749864556,0.935025368384
2020-04-24,2154,54252,,,,,,,154558,112850,204622,2763540,2068066,3578844,12562037,9219819,16464604,0.885116785241,0.83052848306,0.934823325741
2020-04-25,1698,55950,,,,,,,150901,109724,200658,2696885,2012544,3501573,12712938,9329543,16665262,0.884962070175,0.830318746682,0.934626528154
2020-04-26,1329,57279,,,,,,,147342,106656,196607,2631968,1958196,3426925,12860280,9436199,16861869,0.88484392968,0.83018880194,0.934381444068
2020-04-27,1466,58745,,,,,,,143880,103750,192850,2568768,1905028,3354673,13004160,9539949,17054719,0.884772637334,0.830076835736,0.93421476181
2020-04-28,2241,60986,,,,,,,140513,100776,189078,2507257,1852838,3284646,13144673,9640725,17243797,0.884762279584,0.830037572671,0.934064234274
2020-04-29,2521,63507,,,,,,,137243,97924,185464,2447402,1801916,3216878,13281916,9738649,17429261,0.884831671998,0.83006839534,0.933950806645
2020-04-30,2322,65829,,,,,,,134068,95104,181907,2389165,1752322,3151171,13415984,9833753,17611168,0.885005781024,0.830056248524,0.934033884911
2020-05-01,1891,67720,,,,,,,130991,92437,178566,2332517,1703855,3087613,13546975,9926190,17789734,0.885317331374,0.830080056874,0.934056174072
2020-05-02,1692,69412,,,,,,,128010,89769,175241,2277426,1656418,3025855,13674985,10015959,17964975,0.885808729045,0.830031924785,0.934057832991
2020-05-03,1120,70532,,,,,,,125128,87224,171986,2223867,1610220,2965906,13800113,10103183,18136961,0.886533821178,0.830241482211,0.934591235763
2020-05-04,1333,71865,,,,,,,122346,84781,168940,2171821,1565324,2907790,13922459,10187964,18305901,0.887559242434,0.830352414283,0.935473752218
2020-05-05,2318,74183,,,,,,,119668,82440,166003,2121279,1521684,2851445,14042127,10270404,18471904,0.888964456564,0.830527222414,0.93705519229
2020-05-06,2364,76547,,,,,,,117098,80154,163202,2072238,1479197,2796971,14159225,10350558,18635106,0.890839442518,0.830827706987,0.940641417726
2020-05-07,1934,78481,,,,,,,114639,77962,160477,2024701,1437862,2744206,14273864,10428520,18795583,0.893278855545,0.831155586458,0.953932842678
2020-05-08,1747,80228,,,,,,,112298,75849,157829,1978682,1397649,2693202,14386162,10504369,18953412,0.89637223239,0.831704279223,0.969647370521
2020-05-09,1488,81716,,,,,,,110079,73894,155392,1934203,1358688,2643959,14496241,10578263,19108804,0.900191868804,0.831897064594,0.991052813506
2020-05-10,893,82609,,,,,,,107992,72057,153042,1891294,1321020,2596332,14604233,10650320,19261846,0.904783061243,0.832402284236,1.01619934037
2020-05-11,1014,83623,,,,,,,106046,70369,150914,1849997,1284735,2550630,14710279,10720689,19412760,0.91016308702,0.832570832261,1.04999021452
2020-05-12,1627,85250,,,,,,,104252,68751,148960,1810369,1249736,2506728,14814531,10789440,19561720,0.916331948756,0.832999964864,1.07493452213
2020-05-13,1764,87014,,,,,,,102621,67228,147177,1772477,1216190,2464816,14917152,10856668,19708897,0.923289441383,0.833767824149,1.09904889562
2020-05-14,1783,88797,,,,,,,101168,65978,145546,1736403,1184251,2424891,15018320,10922646,19854443,0.931046905646,0.835323229668,1.12274067082
2020-05-15,1681,90478,,,,,,,99904,64841,144221,1702239,1153995,2387199,15118224,10987487,19998664,0.939626398,0.836981473221,1.14649905484
2020-05-16,1216,91694,,,,,,,98843,63808,143094,1670092,1125376,2351717,15217067,11051295,20141758,0.949051530605,0.83919804914,1.16440551824
2020-05-17,758,92452,,,,,,,97998,62905,142113,1640079,1098527,2318579,15315065,11114200,20283871,0.959338887318,0.842201312637,1.17814212248
2020-05-18,1172,93624,,,,,,,97379,62315,141434,1612330,1073640,2288019,15412444,11176515,20425305,0.970490199424,0.846004073406,1.19496596576
2020-05-19,1552,95176,,,,,,,97000,61762,141088,1586985,1050651,2260154,15509444,11238277,20566393,0.982475464122,0.852508399886,1.2284382086
2020-05-20,1526,96702,,,,,,,96871,61574,141238,1564188,1029825,2235376,15606315,11299851,20707631,0.995203387147,0.862142913536,1.24043761017
2020-05-21,1217,97919,,,,,,,97002,61589,141571,1544092,1011313,2213729,15703317,11361440,20849202,1.00849504392,0.872447282482,1.25300693318
2020-05-22,1244,99163,,,,,,,97404,61814,142158,1526856,995227,2195393,15800721,11423254,20991360,1.02208699509,0.874572227887,1.25719445916
2020-05-23,1109,100272,,,,,,,98085,62197,143149,1512644,981643,2180690,15898806,11485451,21134509,1.035675375,0.87545522868,1.26230864857
2020-05-24,622,100894,,,,,,,99056,62743,144441,1501621,970560,2169707,15997862,11548194,21278950,1.04898339794,0.875696004744,1.26784668094
2020-05-25,548,101442,,,,,,,100325,63482,146030,1493955,962055,2162656,16098187,11611676,21424980,1.06181705634,0.875794239482,1.28354234552
2020-05-26,662,102104,,,,,,,101911,64564,148116,1489819,956320,2159817,16200098,11676240,21573096,1.0740819016,0.877276825808,1.29757458946
2020-05-27,1518,103622,,,,,,,103822,65761,150640,1489390,953391,2161439,16303920,11742001,21723736,1.085760367,0.878352430946,1.30725064916
2020-05-28,1178,104800,,,,,,,106065,67370,153686,1492834,953590,2167882,16409985,11809371,21877422,1.09687172317,0.880312828907,1.31238125396
2020-05-29,1160,105960,,,,,,,108651,69233,157017,1500316,956893,2179284,16518636,11878604,22034439,1.10743878528,0.883328368104,1.31945285733
2020-05-30,963,106923,,,,,,,111593,71355,161063,1512005,963446,2196045,16630229,11949959,22195502,1.11751120206,0.886722001337,1.33034996725
2020-05-31,581,107504,,,,,,,114908,73819,165415,1528069,973487,2218282,16745137,12023778,22360917,1.12713125235,0.891653020411,1.33946661584
2020-06-01,776,108280,,,,,,,118613,76544,170181,1548685,987147,2246263,16863750,12100322,22531098,1.13635688387,0.898337665732,1.34595177013
2020-06-02,1068,109348,,,,,,,122723,79624,175299,1574028,1004463,2280049,16986473,12179946,22706397,1.1452004167,0.907908610105,1.34942971271
2020-06-03,1007,110355,,,,,,,127255,83040,181026,1604284,1025733,2319902,17113728,12262986,22887423,1.15364340461,0.92044534841,1.35252127474
2020-06-04,1023,111378,,,,,,,132229,86648,187374,1639641,1050793,2365938,17245957,12349634,23074797,1.16161958298,0.930622180341,1.35521866482
2020-06-05,914,112292,,,,,,,137658,90792,194978,1680297,1079987,2419236,17383615,12440426,23269775,1.1690601114,0.93644527578,1.35568465212
2020-06-06,659,112951,,,,,,,143561,95310,202633,1726454,1113471,2479627,17527176,12535736,23472408,1.17590740417,0.941383616922,1.35490868459
2020-06-07,438,113389,,,,,,,149953,100019,211140,1778321,1151279,2547525,17677129,12635755,23683548,1.18208943652,0.948251367914,1.35454408348
2020-06-08,519,113908,,,,,,,156847,105133,220504,1836113,1193648,2623495,17833976,12740888,23904052,1.1875648546,0.95754293601,1.35472489391
2020-06-09,950,114858,,,,,,,164257,110553,230272,1900044,1240699,2707663,17998233,12851441,24134324,1.19227017627,0.968350147121,1.355713499
2020-06-10,901,115759,,,,,,,172187,116480,240574,1970321,1292595,2800071,18170420,12967921,24374898,1.19616056115,0.984241831156,1.35450095649
2020-06-11,871,116630,,,,,,,180639,122772,252200,2047138,1349589,2901567,18351059,13090693,24627098,1.19921074956,1.00723421055,1.35498292962
2020-06-12,828,117458,,,,,,,189609,129319,264580,2130682,1411522,3012402,18540668,13220012,24891678,1.20138001283,1.0334254958,1.35328706085
2020-06-13,759,118217,,,,,,,199084,136391,277573,2221116,1478656,3132899,18739752,13356403,25169251,1.20265441744,1.05322810436,1.35311222323
2020-06-14,308,118525,,,,,,,209042,143742,291251,2318566,1551024,3263054,18948794,13500145,25460502,1.20298356932,1.04903495493,1.35392000581
2020-06-15,394,118919,,,,,,,219449,151351,305359,2423107,1628524,3402983,19168243,13651496,25765861,1.20236794269,1.04762296163,1.35310501497
2020-06-16,838,119757,,,,,,,230258,159611,319999,2534752,1711563,3552807,19398501,13811107,26085860,1.2007872682,1.03636008992,1.35302705923
2020-06-17,744,120501,,,,,,,241408,167902,333360,2653436,1799806,3710917,19639909,13979009,26419220,1.19825543321,1.03005885805,1.3510930607
2020-06-18,718,121219,,,,,,,252826,176543,347381,2779008,1893272,3877341,19892735,14155552,26766601,1.19479890703,1.02160977596,1.35126206281
2020-06-19,670,121889,,,,,,,264427,185705,361005,2911206,1992307,4051093,20157162,14341257,27127606,1.19043629978,1.01265579996,1.35094417931
2020-06-20,604,122493,,,,,,,276111,194791,375860,3049659,2096297,4232098,20433273,14536048,27503466,1.18519636639,1.00489485164,1.35307903475
2020-06-21,285,122778,,,,,,,287765,204226,390615,3193864,2205207,4420201,20721038,14740274,27894081,1.17910113936,0.996678087871,1.35316215053
2020-06-22,389,123167,,,,,,,299272,213727,403636,3343183,2318901,4612789,21020310,14954001,28297717,1.1722417329,0.988161115145,1.35366185965
2020-06-23,847,124014,,,,,,,310508,223327,417104,3496844,2437073,4809435,21330818,15177328,28714821,1.1647312621,0.98297807312,1.35297425142
2020-06-24,759,124773,,,,,,,321354,232244,429560,3653942,2558745,5008751,21652172,15409572,29144381,1.15670562468,0.97746465704,1.35292058224
2020-06-25,551,125324,,,,,,,331703,241442,441783,3813457,2683688,5209951,21983875,15651014,29586164,1.14830828421,0.973269681893,1.35321455523
2020-06-26,617,125941,,,,,,,341460,250115,452575,3974277,2811012,5410266,22325335,15901129,30038739,1.13965030263,0.968720269495,1.35268599126
2020-06-27,504,126445,,,,,,,350554,258356,463168,4135222,2940036,5608741,22675889,16159485,30501907,1.13085412492,0.963892165913,1.35182629593
2020-06-28,273,126718,,,,,,,358932,265851,471993,4295070,3069498,5803051,23034821,16425336,30973900,1.1220186926,0.960591653801,1.35039808599
2020-06-29,377,127095,,,,,,,366562,272518,479141,4452589,3198266,5990790,23401383,16697854,31453041,1.11323869385,0.956294777626,1.34852203682
2020-06-30,625,127720,,,,,,,373424,278554,486527,4606564,3325473,6171851,23774807,16976408,31939568,1.10458696542,0.954848577266,1.34612545625
2020-07-01,694,128414,,,,,,,379513,284052,493564,4755818,3449948,6345377,24154320,17260460,32433132,1.09609267141,0.951357186324,1.34302772053
2020-07-02,727,129141,,,,,,,384834,288350,499400,4899244,3570439,6511475,24539154,17548810,32932532,1.08776020987,0.948613948914,1.3391786274
2020-07-03,660,129801,,,,,,,389401,292093,504779,5035818,3686032,6668983,24928555,17840903,33437311,1.07955821122,0.946059649305,1.3322417512
2020-07-04,265,130066,,,,,,,393236,295546,509003,5164627,3795914,6817067,25321791,18136449,33946314,1.07146196295,0.944334953234,1.32331753261
2020-07-05,288,130354,,,,,,,396369,297960,511216,5284886,3899119,6952512,25718160,18434409,34457530,1.06345802831,0.941498203302,1.31212709855
2020-07-06,355,130709,,,,,,,398833,300428,514319,5395954,3995335,7076292,26116993,18734837,34971849,1.05555535366,0.938163624739,1.30118927673
2020-07-07,1222,131931,,,,,,,400664,302549,516117,5497346,4084176,7188787,26517657,19037386,35487966,1.04778383336,0.93437344053,1.2898420357
2020-07-08,863,132794,,,,,,,401898,304398,517899,5588736,4165272,7289604,26919555,19341784,36005865,1.04019134961,0.932311404874,1.28298906498
2020-07-09,1003,133797,,,,,,,402573,305352,519089,5669954,4238398,7379137,27322128,19647136,36524954,1.03283480567,0.930917319111,1.27318157293
2020-07-10,824,134621,,,,,,,402725,305666,519302,5740976,4302632,7456665,27724853,19952802,37044256,1.02577260255,0.928953603019,1.26360399811
2020-07-11,690,135311,,,,,,,402390,305630,518692,5801906,4358175,7522789,28127243,20258432,37562948,1.01906257262,0.926689272681,1.25172744229
2020-07-12,459,135770,,,,,,,401602,305087,517713,5852955,4404921,7577339,28528845,20563519,38080661,1.01275442433,0.924698885578,1.23660895955
2020-07-13,367,136137,,,,,,,400394,304326,515664,5894416,4443414,7621011,28929239,20867845,38596325,1.00688005573,0.921310662999,1.22374463921
2020-07-14,926,137063,,,,,,,398798,303399,513220,5926653,4474301,7655094,29328037,21171244,39109545,1.00144833354,0.918191540338,1.20619320318
2020-07-15,968,138031,,,,,,,396846,302109,511071,5950075,4497868,7679664,29724883,21473353,39620616,0.996448896774,0.916875128041,1.19702607501
2020-07-16,943,138974,,,,,,,394566,300891,508112,5965128,4514732,7694257,30119449,21774244,40128728,0.991862000341,0.915312139406,1.17998569128
2020-07-17,930,139904,,,,,,,391989,299320,505112,5972284,4525726,7700023,30511438,22073564,40633840,0.987667021964,0.914504627466,1.16189366149
2020-07-18,868,140772,,,,,,,389141,297196,501503,5972024,4530837,7696820,30900579,22370760,41135343,0.983845257291,0.912622837681,1.14568447178
2020-07-19,447,141219,,,,,,,386050,294985,497956,5964838,4530296,7685841,31286629,22665745,41633299,0.98037844208,0.911643808462,1.13293181751
2020-07-20,514,141733,,,,,,,382739,292198,493994,5951207,4524533,7668659,31669368,22957943,42127293,0.977246744986,0.910784738124,1.12538394161
2020-07-21,1107,142840,,,,,,,379232,289401,489530,5931606,4513492,7643905,32048600,23247344,42616823,0.974428116227,0.91011799506,1.10188945722
2020-07-22,1216,144056,,,,,,,375551,286186,485310,5906492,4497108,7613110,32424151,23533530,43102133,0.97189860048,0.909363003035,1.0721498036
2020-07-23,1094,145150,,,,,,,371716,283161,480482,5876311,4475843,7575707,32795867,23816691,43582615,0.969632839532,0.907599516054,1.06013106217
2020-07-24,1132,146282,,,,,,,367749,280292,476002,5841487,4450734,7532633,33163616,24096983,44058617,0.967604653613,0.905721829644,1.05331432646
2020-07-25,899,147181,,,,,,,363974,277105,471358,5802736,4422118,7484711,33527590,24374088,44529975,0.965787897021,0.904459923328,1.04488245873
2020-07-26,472,147653,,,,,,,360090,273871,466466,5760436,4390295,7432515,33887680,24647959,44996441,0.964157555077,0.903167842367,1.04112317142
2020-07-27,1120,148773,,,,,,,356127,271076,461335,5714961,4356219,7376164,34243807,24919035,45457776,0.962690779121,0.902191662263,1.03792744209
2020-07-28,1374,150147,,,,,,,352114,268232,456202,5666681,4320066,7316741,34595921,25187267,45913978,0.961367522389,0.901349079023,1.03488056336
2020-07-29,1432,151579,,,,,,,348092,265058,450832,5615975,4281672,7254400,34944013,25452325,46364810,0.960170605396,0.900202180496,1.03092109519
2020-07-30,1209,152788,,,,,,,344101,261919,445626,5563230,4241432,7189019,35288114,25714244,46810436,0.959085276988,0.899573460021,1.02846406583
2020-07-31,1243,154031,,,,,,,340129,258682,440584,5508793,4199181,7121560,35628243,25972926,47251020,0.958098524686,0.898858354017,1.0263655081
2020-08-01,1115,155146,,,,,,,336164,255426,435636,5452969,4155245,7052141,35964407,26228352,47686656,0.957198436,0.898080850675,1.02554469987
2020-08-02,403,155549,,,,,,,332215,252149,430703,5396043,4110152,6981396,36296622,26480501,48117359,0.956373813129,0.897325214396,1.02435122036
2020-08-03,530,156079,,,,,,,328289,248721,426319,5338283,4063845,6909811,36624911,26729222,48543678,0.955614079026,0.896167253208,1.02330025904
2020-08-04,1378,157457,,,,,,,324403,245292,421431,5279947,4016892,6837280,36949314,26974514,48965109,0.954910261791,0.895417588536,1.02273714961
2020-08-05,1376,158833,,,,,,,320560,242297,416561,5221275,3969749,6764341,37269874,27216811,49381670,0.954252546427,0.89477974515,1.02221525783
2020-08-06,1253,160086,,,,,,,316762,239053,412070,5162487,3922580,6691136,37586636,27455864,49793740,0.953633050013,0.89337160911,1.0215294726
2020-08-07,1242,161328,,,,,,,313010,235672,407591,5103781,3875057,6618285,37899646,27691536,50201331,0.953045014339,0.892824191625,1.02109615505
2020-08-08,1077,162405,,,,,,,309307,232229,403336,5045339,3826959,6545649,38208953,27923765,50604667,0.952482787403,0.89239330698,1.02063945909
2020-08-09,511,162916,,,,,,,305888,229275,399548,4987253,3779097,6473865,38514841,28153040,51004215,0.953959488262,0.894285589516,1.02180529081
2020-08-10,527,163443,,,,,,,302523,226290,395700,4929686,3731488,6403126,38817364,28379330,51399915,0.955457278069,0.896114651813,1.023684747
2020-08-11,1064,164507,,,,,,,299226,223123,391804,4872786,3683515,6333623,39116590,28602453,51791719,0.956972308724,0.896627847549,1.02452052575
2020-08-12,1505,166012,,,,,,,296009,220079,388345,4816681,3635348,6265784,39412599,28822532,52180064,0.958502343351,0.89863483503,1.02601991689
2020-08-13,1070,167082,,,,,,,292896,217035,385023,4761486,3587315,6199999,39705495,29039567,52565087,0.960047600952,0.900817717737,1.02746481822
2020-08-14,1338,168420,,,,,,,289912,213819,381676,4707296,3539209,6136063,39995407,29253386,52946763,0.961604640188,0.9026697718,1.03001610369
2020-08-15,1034,169454,,,,,,,287039,210975,378703,4654206,3491499,6074197,40282446,29464361,53325466,0.963172465158,0.903254410803,1.03229721344
2020-08-16,571,170025,,,,,,,284265,208166,376402,4602307,3444240,6014969,40566711,29672527,53701868,0.964750222001,0.904024920408,1.0348667404
2020-08-17,446,170471,,,,,,,281589,205314,373897,4551680,3397408,5958168,40848300,29877841,54075765,0.966337580413,0.903357485259,1.03713010471
2020-08-18,1325,171796,,,,,,,279013,202421,371334,4502404,3351114,5903190,41127313,30080262,54447099,0.967934469855,0.904858636714,1.03992078486
2020-08-19,1353,173149,,,,,,,276545,199535,369559,4454547,3305363,5851320,41403858,30279797,54816658,0.969540146067,0.904304448304,1.04250184949
2020-08-20,1079,174228,,,,,,,274185,196910,367411,4408171,3259982,5802175,41678043,30476707,55184069,0.971154164289,0.90504900357,1.04557514152
2020-08-21,1105,175333,,,,,,,271928,194279,365601,4363337,3215212,5755713,41949971,30670986,55549670,0.972776481599,0.90450355316,1.0488040294
2020-08-22,982,176315,,,,,,,269773,191719,363983,4320099,3171263,5712118,42219744,30862705,55913653,0.9744072033,0.9046442325,1.05118747263
2020-08-23,450,176765,,,,,,,267718,189165,362502,4278510,3128206,5671296,42487462,31051870,56276155,0.976046632166,0.906269295014,1.05423396006
2020-08-24,442,177207,,,,,,,265765,186924,361492,4238387,3085860,5633254,42753227,31238794,56637647,0.977694847942,0.907994491999,1.05743940437
2020-08-25,1239,178446,,,,,,,263915,184566,360748,4199779,3044140,5598308,43017142,31423360,56998395,0.97935199286,0.910140179961,1.06070027841
2020-08-26,1225,179671,,,,,,,262167,182336,359852,4162720,3003361,5566359,43279309,31605696,57358247,0.98101844598,0.911423225477,1.06314545096
2020-08-27,1111,180782,,,,,,,260520,180196,359405,4127230,2963485,5537419,43539829,31785892,57717652,0.982694799059,0.910800985708,1.06660079354
2020-08-28,971,181753,,,,,,,258972,177982,359020,4093306,2924439,5511415,43798801,31963874,58076672,0.98438181735,0.911000121882,1.06948076657
2020-08-29,958,182711,,,,,,,257526,175836,358637,4060920,2886462,5488366,44056327,32139710,58435309,0.986080307586,0.910836763169,1.07173856532
2020-08-30,310,183021,,,,,,,256180,173834,358986,4030061,2849328,5468635,44312507,32313544,58794295,0.987791180969,0.91183240801,1.07491400527
2020-08-31,573,183594,,,,,,,254935,171793,359633,4000732,2812959,5451843,44567442,32485337,59153928,0.98951557737,0.911434332487,1.07842353691
2020-09-01,1067,184661,,,,,,,253792,169869,360290,3972935,2777517,5438195,44821234,32655206,59514218,0.991254888751,0.911390854769,1.08162334587
2020-09-02,1056,185717,,,,,,,252750,167938,360841,3946672,2743034,5427652,45073984,32823144,59875059,0.993010726839,0.910970780782,1.08467944707
2020-09-03,1070,186787,,,,,,,251811,165955,361654,3921937,2709454,5419689,45325795,32989099,60236713,0.994784831781,0.910979189741,1.08748347167
2020-09-04,965,187752,,,,,,,250974,164176,362646,3898726,2676725,5414882,45576769,33153275,60599359,0.996579014986,0.910598023025,1.08996663329
2020-09-05,783,188535,,,,,,,250240,162378,363809,3877038,2644825,5413054,45827009,33315653,60963168,0.998395106231,0.910922489239,1.09318990863
2020-09-06,403,188938,,,,,,,249610,160663,365675,3856875,2613771,5414708,46076619,33476316,61328843,1.00023481844,0.911482352517,1.09720923523
2020-09-07,267,189205,,,,,,,249086,158982,367478,3838243,2583592,5419667,46325705,33635298,61696321,1.00209952169,0.911294611998,1.10123585068
2020-09-08,445,189650,,,,,,,248667,157294,369734,3821145,2553970,5427908,46574372,33792592,62066055,1.00398996416,0.909742146765,1.1050436622
2020-09-09,1193,190843,,,,,,,248357,155708,372459,3805586,2525122,5439631,46822729,33948300,62438514,1.00590603444,0.91105603818,1.10903182799
2020-09-10,920,191763,,,,,,,248155,154069,375199,3791574,2496869,5454993,47070884,34102369,62813713,1.00784664103,0.912393714729,1.11304439414
2020-09-11,1213,192976,,,,,,,248064,152653,378301,3779119,2469342,5473911,47318948,34255022,63192014,1.00980973353,0.912393248094,1.11658686139
2020-09-12,714,193690,,,,,,,248085,151373,382341,3768232,2442748,5497255,47567033,34406395,63574355,1.01179245904,0.91271166139,1.12052005238
2020-09-13,378,194068,,,,,,,248221,150039,386235,3758927,2416966,5524878,47815254,34556434,63960590,1.01379141534,0.913325694347,1.12519059253
2020-09-14,422,194490,,,,,,,248473,148770,390252,3751220,2391909,5556168,48063727,34705204,64350842,1.01580294894,0.913954628427,1.12919366995
2020-09-15,1288,195778,,,,,,,248844,147567,394755,3745129,2367687,5591317,48312571,34852771,64745597,1.01782344353,0.914598910916,1.13378500594
2020-09-16,983,196761,,,,,,,249336,146197,399427,3740674,2344023,5630468,48561907,34998968,65145024,1.01984955135,0.914866350866,1.1372761987
2020-09-17,870,197631,,,,,,,249952,144975,404092,3737876,2321065,5673721,48811859,35143943,65549116,1.021878341,0.91465557721,1.14092936898
2020-09-18,936,198567,,,,,,,250695,144070,409841,3736760,2299180,5721907,49062554,35288013,65958957,1.02390735568,0.91421349421,1.14544004867
2020-09-19,712,199279,,,,,,,251567,142892,415955,3737353,2277892,5775206,49314121,35430905,66374912,1.02593459542,0.913769896657,1.15000048862
2020-09-20,227,199506,,,,,,,252572,141757,422104,3739685,2257266,5833482,49566693,35572662,66797016,1.02795845167,0.9132861159,1.15389058927
2020-09-21,356,199862,,,,,,,253713,140807,428365,3743787,2237406,5896142,49820406,35713469,67225381,1.02997762575,0.91328508162,1.15805730134
2020-09-22,921,200783,,,,,,,254993,139961,434700,3749695,2218383,5963344,50075399,35853430,67660081,1.03199105366,0.913929192589,1.16272838337
2020-09-23,1098,201881,,,,,,,256417,139209,442581,3757444,2200299,6036185,50331816,35992639,68102662,1.03399784529,0.914167745147,1.16670416213
2020-09-24,914,202795,,,,,,,257987,138514,449624,3767074,2183110,6113350,50589803,36131153,68552286,1.03599723637,0.913921192627,1.17057688436
2020-09-25,952,203747,,,,,,,259708,137834,458482,3778627,2166879,6196631,50849511,36268987,69010768,1.03798854946,0.912974582067,1.17440141642
2020-09-26,740,204487,,,,,,,261584,137187,467477,3792147,2151418,6285801,51111095,36406174,69478245,1.03997116266,0.913074088258,1.17817384267
2020-09-27,266,204753,,,,,,,263618,136535,476815,3807679,2136584,6380271,51374713,36542709,69955060,1.04194448534,0.914552919229,1.18207976678
2020-09-28,316,205069,,,,,,,265813,135914,486723,3825271,2122464,6480765,51640526,36678623,70441783,1.04390794054,0.914406864444,1.185993832
2020-09-29,914,205983,,,,,,,268174,135386,497891,3844972,2109087,6588407,51908700,36814009,70939674,1.04586095215,0.914261556473,1.18986718931
2020-09-30,946,206929,,,,,,,270703,134949,509274,3866830,2096472,6702929,52179403,36948958,71448948,1.04780293526,0.914116965777,1.19369683344
2020-10-01,857,207786,,,,,,,273404,134463,521158,3890898,2084743,6824661,52452807,37083421,71970106,1.04973328829,0.913973080616,1.19747469011
2020-10-02,906,208692,,,,,,,276284,133970,532561,3917230,2073743,6953135,52729091,37217391,72502667,1.05165138645,0.914126620168,1.20133900406
2020-10-03,,,742.049169108,478,1091,209434.049169,209170,209783,279348,133489,545452,3945883,2063165,7088753,53008439,37350880,73048119,1.05355657645,0.914527498436,1.20463724808
2020-10-04,,,739.883194968,472,1096,210173.932364,209642,210879,282600,133095,559409,3976917,2053369,7232200,53291039,37483975,73607528,1.05544817213,0.914582467799,1.20827186488
2020-10-05,,,738.02767609,467,1101,210911.96004,210110,211979,286044,132682,572063,4010389,2044293,7382145,53577083,37616657,74179591,1.05732545075,0.914587553977,1.21234092615
2020-10-06,,,736.486608652,461,1107,211648.446649,210571,213086,289684,132261,586366,4046360,2035749,7540125,53866767,37748918,74765957,1.05918764952,0.914562388055,1.21606401869
2020-10-07,,,735.264105862,457,1115,212383.710755,211029,214201,293526,132157,599754,4084894,2027949,7705161,54160293,37881075,75365711,1.0610339623,0.91453715754,1.2193750002
2020-10-08,,,734.364915669,452,1124,213118.07567,211481,215324,297576,132192,614476,4126053,2020937,7877028,54457869,38013267,75980187,1.06286353635,0.91451186971,1.22218680638
2020-10-09,,,733.794364706,447,1133,213851.870035,211929,216457,301835,131957,629949,4169901,2014391,8057314,54759704,38145224,76610136,1.06467546862,0.914486532409,1.22548203379
2020-10-10,,,733.558123066,443,1144,214585.428158,212372,217601,306307,131902,645753,4216500,2008470,8244546,55066011,38277126,77255889,1.06646002959,0.914461153776,1.22869603353
2020-10-11,,,733.662209222,438,1156,215319.090367,212811,218756,310999,132003,663088,4265915,2003292,8440102,55377010,38409129,77918977,1.06822435528,0.914435742065,1.23116230445
2020-10-12,,,734.113013057,434,1168,216053.20338,213246,219924,315912,132070,680785,4318209,1998834,8644016,55692922,38541199,78599762,1.06995024621,0.915534948683,1.23217571063
2020-10-13,,,734.917322549,430,1182,216788.120703,213676,221105,321053,132194,699588,4373449,1995122,8856831,56013975,38673393,79299350,1.071640155,0.915370088645,1.23327519228
2020-10-14,,,736.082334272,426,1197,217524.203037,214103,222301,326425,132265,719200,4431701,1992014,9078095,56340400,38805658,80018550,1.07327847883,0.915205356701,1.23533824177
2020-10-15,,,737.615623949,422,1212,218261.818661,214526,223512,332029,132452,739668,4493027,1989523,9308442,56672429,38938110,80758218,1.07485676408,0.915040780481,1.23678188204
2020-10-16,,,739.525756126,418,1228,219001.344417,214945,224739,337871,132573,761298,4557495,1987638,9548536,57010300,39070683,81519516,1.07639403995,0.914876386809,1.23882649942
2020-10-17,,,742.97076523,416,1248,219744.315183,215361,225986,343955,132799,781602,4625166,1986473,9797536,57354255,39203482,82301118,1.07786264832,0.914712345879,1.24090802092
2020-10-18,,,746.832064734,413,1268,220491.147247,215775,227254,350283,133065,804953,4696100,1986056,10056999,57704538,39336547,83106071,1.07927574572,0.91452286077,1.23958916855
2020-10-19,,,751.120012446,410,1289,221242.26726,216186,228542,356853,133438,827939,4770353,1986406,10325476,58061391,39469985,83934010,1.08062772845,0.914803124411,1.23824628504
2020-10-20,,,755.845497975,408,1311,221998.112758,216595,229852,363669,133818,850221,4847977,1987549,10603557,58425060,39603803,84784231,1.08187950067,0.915145874923,1.23968594695
2020-10-21,,,761.019950851,406,1337,222759.132709,217002,231189,370735,134219,874344,4929029,1989516,10891468,58795795,39738022,85658575,1.08305167457,0.91542573541,1.23792414302
2020-10-22,,,766.655304681,404,1362,223525.788013,217407,232550,378054,134768,900155,5013556,1992130,11191802,59173849,39872790,86558730,1.08413756863,0.915506350288,1.23782998819
2020-10-23,,,772.763947714,402,1389,224298.551961,217810,233938,385624,135366,924895,5101605,1995304,11502168,59559473,40008156,87483625,1.08514639077,0.915795750363,1.23676783983
2020-10-24,,,779.358723691,401,1419,225077.910685,218211,235356,393443,136049,949214,5193213,1999397,11821381,59952916,40144205,88432839,1.08607056601,0.915939709722,1.23680722434
2020-10-25,,,786.452919825,400,1451,225864.363604,218612,236806,401510,136748,978358,5288415,2004243,12153934,60354426,40280953,89411197,1.08692045121,0.916154204675,1.23546270537
2020-10-26,,,794.060277658,399,1484,226658.423882,219011,238289,409821,137549,1005319,5387238,2009787,12496111,60764247,40418502,90416516,1.08769734057,0.91631546393,1.23327255673
2020-10-27,,,802.194952155,398,1518,227460.618834,219410,239806,418377,138299,1032888,5489702,2016013,12848134,61182624,40556801,91449404,1.0884179132,0.916564910889,1.23008683053
2020-10-28,,,810.871352466,396,1556,228271.490187,219807,241361,427174,139257,1061348,5595823,2023071,13209806,61609798,40696058,92510752,1.08907490107,0.917102234711,1.22990058944
2020-10-29,,,820.104197546,395,1595,229091.594384,220202,242955,436202,140348,1091123,5705599,2031146,13581646,62046000,40836406,93601875,1.08966229566,0.916758857254,1.22843366633
2020-10-30,,,829.908521401,394,1633,229921.502906,220598,244586,445455,141224,1122369,5819026,2039909,13964245,62491455,40977630,94724244,1.09016949125,0.916825352848,1.22630713418
2020-10-31,,,840.299692204,393,1675,230761.802598,220992,246261,454929,142285,1153492,5936084,2049615,14356309,62946384,41119915,95877736,1.09058429318,0.916890475979,1.22490975479
2020-11-01,,,851.293370998,393,1720,231613.095969,221386,247980,464620,143350,1183821,6056748,2060162,14758403,63411004,41263265,97061557,1.09093341471,0.916954335684,1.22344984335
