date,actual_deaths,total_deaths,predicted_deaths_mean,predicted_deaths_lower,predicted_deaths_upper,predicted_total_deaths_mean,predicted_total_deaths_lower,predicted_total_deaths_upper,predicted_new_infected_mean,predicted_new_infected_lower,predicted_new_infected_upper,predicted_current_infected_mean,predicted_current_infected_lower,predicted_current_infected_upper,predicted_total_infected_mean,predicted_total_infected_lower,predicted_total_infected_upper,r_values_mean,r_values_lower,r_values_upper
2020-02-05,0,0,,,,,,,125,65,178,125,65,178,125,65,178,2.26254632781,2.1,2.4
2020-02-06,0,0,,,,,,,125,65,178,251,130,356,250,130,356,2.26253691519,2.09999087781,2.39999969306
2020-02-07,0,0,,,,,,,125,65,178,376,194,534,375,195,534,2.26253372945,2.09998785198,2.39999951553
2020-02-08,0,0,,,,,,,125,65,178,501,260,712,500,260,712,2.26252945291,2.09998382187,2.39999927998
2020-02-09,0,0,,,,,,,287,162,404,788,438,1103,787,422,1116,2.26252370708,2.09997845398,2.39999890251
2020-02-10,0,0,,,,,,,287,162,404,1076,606,1503,1074,584,1520,2.26251598011,2.099971304,2.39999832583
2020-02-11,0,0,,,,,,,287,162,404,1363,772,1904,1361,746,1924,2.26250557902,2.09996177995,2.39999743391
2020-02-12,0,0,,,,,,,287,162,404,1650,936,2306,1648,908,2328,2.26249156442,2.09994909312,2.39999610709
2020-02-13,0,0,,,,,,,467,279,650,2117,1236,2936,2115,1187,2978,2.26247266134,2.09993219269,2.39999415279
2020-02-14,0,0,,,,,,,674,411,937,2791,1652,3867,2789,1598,3915,2.2624172957,2.09987925408,2.39996708413
2020-02-15,0,0,,,,,,,1216,751,1630,4008,2460,5459,4005,2349,5545,2.26237906235,2.09984541717,2.39995973596
2020-02-16,0,0,,,,,,,2410,1476,3099,6418,4065,8496,6415,3825,8644,2.26232020109,2.09979316439,2.39994304641
2020-02-17,0,0,,,,,,,3898,2537,4931,10316,6735,13340,10313,6362,13575,2.26224480329,2.0997278734,2.39992320895
2020-02-18,0,0,,,,,,,4314,2853,5468,14630,9630,18782,14627,9215,19043,2.26214591997,2.09964386256,2.39989780458
2020-02-19,0,0,,,,,,,5071,3414,6417,19701,13109,25157,19698,12629,25460,2.26201439738,2.0995343388,2.39986364179
2020-02-20,0,0,,,,,,,5210,3522,6608,24786,16578,31578,24908,16151,32068,2.26183698233,2.09938961854,2.39981541593
2020-02-21,0,0,,,,,,,5740,3940,7271,30401,20477,38651,30648,20091,39339,2.26159602628,2.09919719344,2.39974591397
2020-02-22,0,0,,,,,,,6828,4759,8656,37103,25218,47091,37476,24850,47995,2.26127138051,2.09894249148,2.39964813924
2020-02-23,0,0,,,,,,,8170,5775,10336,45148,31023,57174,45646,30625,58331,2.26083399406,2.09860722276,2.3995094919
2020-02-24,0,0,,,,,,,10381,7314,13217,55242,38255,69928,56027,37939,71548,2.2602422379,2.09816467877,2.39931548098
2020-02-25,0,0,,,,,,,16263,10910,20682,71217,49177,90088,72290,48849,92230,2.25943884558,2.09757924358,2.39903438569
2020-02-26,0,0,,,,,,,19660,13413,25031,90590,62471,114677,91950,62262,117261,2.25834490184,2.09680338846,2.3986146898
2020-02-27,0,0,,,,,,,21444,14517,27496,111746,76840,141754,113394,76779,144757,2.25685349512,2.09572423366,2.39801724226
2020-02-28,0,0,,,,,,,26082,17476,33794,137361,94033,174889,139476,94255,178551,2.25481749309,2.09420863094,2.39714678199
2020-02-29,1,1,,,,,,,31895,20827,41985,168582,114457,215895,171371,115082,220536,2.25203386379,2.09214521409,2.39587037877
2020-03-01,0,1,,,,,,,41424,26479,55145,208790,140246,269299,212795,141561,275681,2.24822377857,2.089591145,2.39399419204
2020-03-02,5,6,,,,,,,51534,32599,69223,257914,171476,335285,264329,174160,344904,2.24300646316,2.08594471363,2.3912306096
2020-03-03,1,7,,,,,,,63955,40295,86574,317971,209327,416784,328284,214455,431478,2.2358660824,2.08126226853,2.38715649211
2020-03-04,4,11,,,,,,,78487,48815,107229,392143,255385,518374,406771,263270,538707,2.22611047319,2.07422569088,2.38115198371
2020-03-05,1,12,,,,,,,98173,60492,134792,485245,312564,646563,504944,323762,673499,2.21282464604,2.06584125184,2.37236174706
2020-03-06,2,14,,,,,,,120339,73380,166164,600374,382531,805928,625283,397142,839663,2.19482699972,2.05215937169,2.35960921455
2020-03-07,3,17,,,,,,,145432,88851,201635,740066,467532,1000139,770715,485993,1041298,2.17064412442,2.03108584624,2.34161812297
2020-03-08,4,21,,,,,,,172908,106954,238486,906146,569713,1229882,943623,592947,1279784,2.1385335011,2.00138169795,2.31473925844
2020-03-09,1,22,,,,,,,202040,128381,274330,1100017,692178,1493903,1145663,721328,1554114,2.09659778902,1.94440694144,2.27782286501
2020-03-10,6,28,,,,,,,231770,153553,310791,1321406,838153,1791616,1377433,874881,1864905,2.04303961406,1.86868408151,2.24642910359
2020-03-11,5,33,,,,,,,258340,176347,345520,1563483,1003539,2116400,1635773,1051228,2210425,1.97657749637,1.78392157328,2.20919613781
2020-03-12,10,43,,,,,,,280126,193616,372839,1823949,1183599,2464225,1915899,1244844,2583264,1.89695994735,1.68820820309,2.15341967004
2020-03-13,8,51,,,,,,,296909,206465,392711,2099415,1375432,2829413,2212808,1451309,2975975,1.80539874238,1.57116844035,2.10161241059
2020-03-14,7,58,,,,,,,308447,214427,403929,2381780,1572317,3199485,2521255,1665736,3379904,1.70469144071,1.45518393109,2.04403277894
2020-03-15,12,70,,,,,,,316085,220908,414157,2665969,1772483,3571504,2837340,1886644,3794061,1.59891271777,1.3292161279,1.97753438757
2020-03-16,27,97,,,,,,,320281,226839,424205,2944827,1973102,3940389,3157621,2113483,4218266,1.49276753114,1.2185316164,1.89195878363
2020-03-17,35,132,,,,,,,321948,231181,428847,3215240,2172106,4299801,3479569,2344664,4647113,1.39084172563,1.12433373004,1.78460214004
2020-03-18,59,191,,,,,,,321956,234445,429214,3473242,2366909,4642169,3801525,2579109,5076327,1.29697294922,1.05205207295,1.66712315975
2020-03-19,73,264,,,,,,,320835,237253,426354,3715590,2556249,4960865,4122360,2816362,5502681,1.21385848784,0.999893517449,1.54468584443
2020-03-20,99,363,,,,,,,319059,239590,424014,3936476,2736518,5249473,4441419,3055952,5926695,1.14291459178,0.963967449517,1.43400457898
2020-03-21,99,462,,,,,,,316747,241123,421526,4132883,2905669,5504177,4758166,3297075,6348221,1.08435145197,0.938123278933,1.3359812811
2020-03-22,110,572,,,,,,,314000,241664,416866,4301451,3060035,5718688,5072166,3538739,6765087,1.03741227646,0.921282725765,1.25181815195
2020-03-23,189,761,,,,,,,310958,241876,410989,4439500,3196617,5890440,5383124,3780615,7176076,1.0007083285,0.899273048895,1.17519370234
2020-03-24,239,1000,,,,,,,307666,241629,403046,4545125,3311592,6018279,5690790,4022244,7579122,0.972563660718,0.881123202902,1.11039505919
2020-03-25,324,1324,,,,,,,304161,240840,395466,4617517,3400570,6101894,5994951,4263084,7974588,0.951292605283,0.868668922041,1.05875031546
2020-03-26,408,1732,,,,,,,300440,238736,388959,4659617,3464450,6144414,6295391,4501820,8363547,0.935374157894,0.859541554209,1.02163980074
2020-03-27,518,2250,,,,,,,296488,234676,381597,4675978,3506167,6152287,6591879,4736496,8745144,0.923530583863,0.853579954174,0.994039501619
2020-03-28,633,2883,,,,,,,292309,230529,374241,4671378,3530116,6133007,6884188,4967025,9119385,0.914739465887,0.849234054464,0.978315751684
2020-03-29,586,3469,,,,,,,287940,226131,366851,4650871,3540972,6095195,7172128,5193156,9486236,0.908209550292,0.845697543703,0.967293841899
2020-03-30,692,4161,,,,,,,283332,221953,359604,4618118,3540582,6040251,7455460,5415109,9845840,0.903342352175,0.843306094336,0.959304220894
2020-03-31,1085,5246,,,,,,,278533,217394,351930,4576369,3529319,5968098,7733993,5632503,10197770,0.899692211963,0.841937965343,0.954130677995
2020-04-01,1172,6418,,,,,,,273559,212969,344522,4527981,3509128,5884302,8007552,5845472,10542292,0.896930746893,0.840897539525,0.950496758831
2020-04-02,1503,7921,,,,,,,268435,208472,337336,4474460,3481329,5793302,8275987,6053944,10879628,0.894817661128,0.839671802591,0.947835680011
2020-04-03,1392,9313,,,,,,,263188,204016,330894,4416813,3446451,5698815,8539175,6257960,11210522,0.893177885202,0.838630133936,0.94559051514
2020-04-04,1523,10836,,,,,,,257840,199593,324019,4355594,3405062,5599848,8797015,6457553,11534541,0.891884195922,0.837960038268,0.943856053906
2020-04-05,1590,12426,,,,,,,252424,195300,317705,4291271,3358232,5497242,9049439,6652853,11852246,0.890844254303,0.837317531823,0.942413711871
2020-04-06,1770,14196,,,,,,,246973,190883,311056,4224244,3306808,5392705,9296412,6843736,12163302,0.88999105918,0.836519950349,0.941271714889
2020-04-07,2571,16767,,,,,,,241519,186520,304420,4154805,3251096,5287332,9537931,7030256,12467722,0.889275973512,0.835872756725,0.940458652783
2020-04-08,2146,18913,,,,,,,236092,182104,297845,4083231,3191369,5183090,9774023,7212360,12765567,0.888663656396,0.835416242148,0.939791130598
2020-04-09,2228,21141,,,,,,,230718,177857,291301,4009788,3128246,5079642,10004741,7390217,13056868,0.888128391705,0.834896879041,0.939286513397
2020-04-10,2218,23359,,,,,,,225421,173720,284650,3934769,3063073,4975908,10230162,7563937,13341518,0.887651433203,0.834492441377,0.938704773679
2020-04-11,2119,25478,,,,,,,220217,169490,278303,3858498,2997755,4873026,10450379,7733427,13619821,0.887216112092,0.83416181481,0.938242094882
2020-04-12,1816,27294,,,,,,,215118,165421,272060,3781307,2932554,4771104,10665497,7898848,13891881,0.886816618288,0.833776539822,0.937852586475
2020-04-13,1946,29240,,,,,,,210134,161424,266157,3703502,2867796,4670552,10875631,8060272,14158038,0.886445699774,0.833400684775,0.937497358065
2020-04-14,2455,31695,,,,,,,205269,157412,260421,3625439,2803231,4571437,11080900,8217684,14418459,0.886095299759,0.833081315865,0.93717611824
2020-04-15,2609,34304,,,,,,,200524,153441,254810,3547430,2739284,4474323,11281424,8371125,14673269,0.885771020328,0.83279103138,0.936869307971
2020-04-16,2176,36480,,,,,,,195901,149639,249467,3469772,2675980,4379248,11477325,8520764,14922736,0.885460971908,0.832469366652,0.936570703743
2020-04-17,2093,38573,,,,,,,191397,145962,244325,3392734,2613501,4286219,11668722,8666726,15167061,0.885167951777,0.832212614111,0.936259008839
2020-04-18,1960,40533,,,,,,,187011,142409,239300,3316557,2551936,4194604,11855733,8809135,15406361,0.884888992839,0.831994531663,0.935993748343
2020-04-19,1931,42464,,,,,,,182738,138860,234546,3241456,2491238,4105133,12038471,8947995,15640907,0.884625432915,0.831769679772,0.935713147293
2020-04-20,2186,44650,,,,,,,178577,135223,229789,3167608,2431171,4017238,12217048,9083218,15870696,0.884376371645,0.831528707792,0.935442687943
2020-04-21,2548,47198,,,,,,,174523,131815,225236,3095158,2372101,3931466,12391571,9215033,16095932,0.884142533144,0.831321854009,0.935192018705
2020-04-22,2434,49632,,,,,,,170574,128595,220763,3024213,2314145,3847905,12562145,9343628,16316695,0.883925728224,0.831150931023,0.934959804002
2020-04-23,2466,52098,,,,,,,166728,125318,216608,2954850,2257325,3766791,12728873,9468946,16533303,0.883729250424,0.830932671272,0.934691048484
2020-04-24,2154,54252,,,,,,,162983,121981,212420,2887114,2201408,3688050,12891856,9590927,16745723,0.883557536569,0.830769691133,0.934439129688
2020-04-25,1698,55950,,,,,,,159337,118770,208444,2821030,2146414,3611983,13051193,9709697,16954167,0.883416580199,0.830571048042,0.934226855345
2020-04-26,1329,57279,,,,,,,155789,115631,204595,2756603,2092518,3538397,13206982,9825328,17158762,0.883314998296,0.830446180238,0.933988518528
2020-04-27,1466,58745,,,,,,,152338,112614,200761,2693822,2039680,3467196,13359320,9937942,17359523,0.883264007129,0.83034959322,0.933796532734
2020-04-28,2241,60986,,,,,,,148981,109550,196997,2632669,1987777,3398119,13508301,10047492,17556520,0.883278924221,0.830350518432,0.933720099116
2020-04-29,2521,63507,,,,,,,145720,106661,193476,2573121,1936995,3331239,13654021,10154153,17749996,0.883380209992,0.830312062339,0.933531209669
2020-04-30,2322,65829,,,,,,,142555,103818,190018,2515152,1887340,3266492,13796576,10257971,17940014,0.883594927786,0.830283001864,0.933555363012
2020-05-01,1891,67720,,,,,,,139488,101108,186735,2458739,1838785,3203790,13936064,10359079,18126749,0.883958567255,0.830239639924,0.933415380195
2020-05-02,1692,69412,,,,,,,136518,98459,183547,2403859,1791255,3143028,14072582,10457538,18310296,0.884517019424,0.830396160989,0.933539281904
2020-05-03,1120,70532,,,,,,,133647,95914,180447,2350495,1744735,3084179,14206229,10553452,18490743,0.885328478542,0.83044663714,0.933649674982
2020-05-04,1333,71865,,,,,,,130880,93413,177451,2298637,1699260,3027081,14337109,10646865,18668194,0.886464788138,0.830578114648,0.93417814482
2020-05-05,2318,74183,,,,,,,128221,90965,174651,2248282,1654974,2971934,14465330,10737830,18842845,0.888011344757,0.831032768589,0.935309255185
2020-05-06,2364,76547,,,,,,,125673,88568,171934,2199432,1611703,2918619,14591003,10826398,19014779,0.890064322159,0.831267936814,0.939915873473
2020-05-07,1934,78481,,,,,,,123244,86385,169335,2152102,1569469,2867178,14714247,10912783,19184114,0.89272388348,0.831739316747,0.953247161112
2020-05-08,1747,80228,,,,,,,120940,84320,166916,2106314,1528451,2817473,14835187,10997103,19351030,0.896082836043,0.832002436843,0.969572061884
2020-05-09,1488,81716,,,,,,,118771,82341,164577,2062103,1488796,2769616,14953958,11079444,19515607,0.900212486968,0.832212525091,0.990095622253
2020-05-10,893,82609,,,,,,,116749,80486,162308,2019514,1450503,2723468,15070707,11159930,19677915,0.905150976871,0.832643532803,1.01633372181
2020-05-11,1014,83623,,,,,,,114883,78820,160312,1978609,1413685,2679174,15185590,11238750,19838227,0.910901475282,0.832915184958,1.0488991199
2020-05-12,1627,85250,,,,,,,113190,77231,158531,1939461,1378297,2636936,15298780,11315981,19996758,0.917444150825,0.833949679772,1.07867036508
2020-05-13,1764,87014,,,,,,,111683,75847,156960,1902163,1344594,2596894,15410463,11391828,20153718,0.924756441147,0.834663788053,1.10741832855
2020-05-14,1783,88797,,,,,,,110377,74661,155597,1866820,1312596,2559008,15520840,11466489,20309315,0.932828827374,0.836161291682,1.1329360729
2020-05-15,1681,90478,,,,,,,109289,73620,154493,1833554,1282399,2523473,15630129,11540109,20463808,0.941667273339,0.838177334271,1.15394436135
2020-05-16,1216,91694,,,,,,,108434,72797,153554,1802499,1254095,2490285,15738563,11612906,20617362,0.951285490965,0.84083167998,1.17043615371
2020-05-17,758,92452,,,,,,,107824,72080,152967,1773805,1227723,2459696,15846387,11684986,20770329,0.961695811297,0.844381043268,1.18251084518
2020-05-18,1172,93624,,,,,,,107473,71511,152869,1747632,1203334,2432103,15953860,11756497,20923198,0.972899870179,0.849236469261,1.19534187457
2020-05-19,1552,95176,,,,,,,107395,71219,153168,1724147,1181160,2407798,16061255,11827716,21076366,0.984870959131,0.855818451888,1.22763449785
2020-05-20,1526,96702,,,,,,,107600,71104,153668,1703526,1161323,2386784,16168855,11898820,21230034,0.997525290938,0.864729976602,1.23734174595
2020-05-21,1217,97919,,,,,,,108099,71252,154485,1685952,1144041,2369299,16276954,11970072,21384519,1.01069716008,0.875293846061,1.25243467761
2020-05-22,1244,99163,,,,,,,108900,71714,155737,1671607,1129414,2355662,16385854,12041786,21540256,1.02414242725,0.875713539061,1.25718950998
2020-05-23,1109,100272,,,,,,,110014,72470,157252,1660681,1117610,2345956,16495868,12114256,21697508,1.03758098929,0.875852639749,1.26775444383
2020-05-24,622,100894,,,,,,,111451,73480,158915,1653360,1108796,2340253,16607319,12187736,21856423,1.05076147577,0.876032765017,1.27921409021
2020-05-25,548,101442,,,,,,,113219,74600,161233,1649831,1102960,2339137,16720538,12262336,22017656,1.06351442097,0.876742916625,1.28780363938
2020-05-26,662,102104,,,,,,,115338,76097,163905,1650286,1100291,2342688,16835876,12338433,22181561,1.0757676658,0.878424852043,1.2975098219
2020-05-27,1518,103622,,,,,,,117819,77924,166852,1654915,1101038,2350963,16953695,12416357,22348413,1.08752333593,0.879601467672,1.30846819587
2020-05-28,1178,104800,,,,,,,120667,80163,170429,1663899,1105409,2364384,17074362,12496520,22518842,1.09881570698,0.881603862746,1.31297236588
2020-05-29,1160,105960,,,,,,,123897,82670,174443,1677419,1113470,2383180,17198259,12579190,22693285,1.10968168986,0.883529898143,1.31956765314
2020-05-30,963,106923,,,,,,,127524,85433,178926,1695653,1125328,2407564,17325783,12664623,22872211,1.12017768625,0.886754011679,1.31855991327
2020-05-31,581,107504,,,,,,,131566,88578,184046,1718786,1141148,2438015,17457349,12753201,23056257,1.13034395263,0.891537953137,1.33431550249
2020-06-01,776,108280,,,,,,,136046,92079,189924,1747008,1161181,2474919,17593395,12845280,23246181,1.14021616353,0.898181119243,1.34115382595
2020-06-02,1068,109348,,,,,,,140979,95834,195968,1780514,1185549,2517965,17734374,12941114,23442149,1.14976937624,0.907656420826,1.34747555357
2020-06-03,1007,110355,,,,,,,146388,99974,202639,1819507,1214335,2567364,17880762,13041088,23644788,1.1589279455,0.920342987877,1.35196522753
2020-06-04,1023,111378,,,,,,,152292,104460,210279,1864199,1247721,2623885,18033054,13145548,23855067,1.16755603862,0.930151771913,1.35483544473
2020-06-05,914,112292,,,,,,,158712,109371,218304,1914812,1285868,2687624,18191766,13254919,24073371,1.17553251077,0.936891870312,1.35542631797
2020-06-06,659,112951,,,,,,,165666,114659,227005,1971578,1328831,2758807,18357432,13369578,24300376,1.18276528045,0.942198039189,1.35514792115
2020-06-07,438,113389,,,,,,,173174,120230,236459,2034738,1376600,2837920,18530606,13489808,24536835,1.18916602751,0.949967669981,1.35227745362
2020-06-08,519,113908,,,,,,,181251,126502,247316,2104537,1429617,2926219,18711857,13616310,24784151,1.19470224298,0.958751011651,1.35354684888
2020-06-09,950,114858,,,,,,,189909,133030,258774,2181227,1488045,3023659,18901766,13749340,25042925,1.19932357827,0.971655317849,1.35304630051
2020-06-10,901,115759,,,,,,,199152,139940,269849,2265041,1551881,3129538,19100918,13889280,25312774,1.20302158803,0.987057881427,1.35354659867
2020-06-11,871,116630,,,,,,,208980,147320,282998,2356201,1621283,3245655,19309898,14036600,25595772,1.2058011883,1.00995536801,1.3537714065
2020-06-12,828,117458,,,,,,,219380,155123,296423,2454914,1696243,3371629,19529278,14191723,25892195,1.20765833877,1.03782665244,1.35401585947
2020-06-13,759,118217,,,,,,,230330,163472,310042,2561347,1777047,3507230,19759608,14355195,26202237,1.20860798691,1.05716596146,1.3556098519
2020-06-14,308,118525,,,,,,,241797,172275,324330,2675621,1863879,3652659,20001405,14527470,26526567,1.20862148283,1.0539850109,1.35483723346
2020-06-15,394,118919,,,,,,,253730,181641,338711,2797784,1956918,3807387,20255135,14709111,26865278,1.2077135466,1.04869882273,1.35616442446
2020-06-16,838,119757,,,,,,,266064,191623,353867,2927802,2056433,3971418,20521199,14900734,27219145,1.20585958517,1.03987112969,1.35601933842
2020-06-17,744,120501,,,,,,,278718,201403,369700,3065541,2161999,4145262,20799917,15102137,27588845,1.20306090443,1.02724240181,1.35704546676
2020-06-18,718,121219,,,,,,,291599,211311,385107,3210752,2273334,4327799,21091516,15313448,27973952,1.19932161477,1.01279554048,1.35782200324
2020-06-19,670,121889,,,,,,,304594,221380,399368,3363054,2390254,4516947,21396110,15534828,28373320,1.19462961927,1.00668799923,1.35813316824
2020-06-20,604,122493,,,,,,,317583,231941,414672,3521925,2512834,4713334,21713693,15766769,28787992,1.18900025476,0.992868839572,1.35801933438
2020-06-21,285,122778,,,,,,,330436,242520,430911,3686696,2640697,4917233,22044129,16009289,29218903,1.18244796593,0.989286407903,1.35764112455
2020-06-22,389,123167,,,,,,,343020,253297,445470,3856542,2773751,5126193,22387149,16262586,29664373,1.17507182583,0.985163972532,1.35695788847
2020-06-23,847,124014,,,,,,,355204,264573,459706,4030496,2911785,5338493,22742353,16527159,30124079,1.16700100084,0.976822412552,1.35568894424
2020-06-24,759,124773,,,,,,,366871,274432,471879,4207458,3053169,5551540,23109224,16801591,30595958,1.15838449846,0.970684545827,1.35413260594
2020-06-25,551,125324,,,,,,,377917,284039,484487,4386223,3197259,5766157,23487141,17085630,31080445,1.14937839894,0.96411607664,1.35305561032
2020-06-26,617,125941,,,,,,,388255,293751,497247,4565498,3343715,5980443,23875396,17379381,31577692,1.14010370431,0.957021790998,1.35205944654
2020-06-27,504,126445,,,,,,,397819,302568,508695,4743938,3491175,6192748,24273215,17681949,32086387,1.13068929723,0.945484439755,1.3516574178
2020-06-28,273,126718,,,,,,,406566,310786,518231,4920173,3638548,6401012,24679781,17992735,32604618,1.12123224803,0.941019964961,1.35026052883
2020-06-29,377,127095,,,,,,,414467,317361,526561,5092843,3783708,6603355,25094248,18310096,33131179,1.11181752907,0.934494098873,1.34681703037
2020-06-30,625,127720,,,,,,,421515,323667,535152,5260629,3925794,6799907,25515763,18633763,33666331,1.10250126536,0.929763327377,1.34445086275
2020-07-01,694,128414,,,,,,,427718,329463,541898,5422283,4063690,6988039,25943481,18963226,34208229,1.09329784001,0.926964085892,1.34204601988
2020-07-02,727,129141,,,,,,,433094,334712,547728,5576658,4197051,7166156,26376575,19297938,34755957,1.08420344808,0.922599599823,1.33449313316
2020-07-03,660,129801,,,,,,,437673,338855,552153,5722733,4324620,7333229,26814248,19636793,35308110,1.07519269739,0.919887903989,1.32482203916
2020-07-04,265,130066,,,,,,,441490,342819,555847,5859628,4446058,7489702,27255738,19979612,35863957,1.06626107443,0.91672635622,1.31588557991
2020-07-05,288,130354,,,,,,,444584,346028,559811,5986629,4560099,7634785,27700322,20325640,36423768,1.05743235351,0.912451667617,1.30979799134
2020-07-06,355,130709,,,,,,,446998,348425,562620,6103190,4665937,7766428,28147320,20674065,36986388,1.04876148751,0.908517108845,1.30102405594
2020-07-07,1222,131931,,,,,,,448774,349915,564303,6208945,4762474,7885194,28596094,21023980,37550691,1.04032082888,0.905538332537,1.28916878255
2020-07-08,863,132794,,,,,,,449958,351235,565309,6303698,4849078,7990729,29046052,21375215,38116000,1.03218797239,0.904295267043,1.27962056067
2020-07-09,1003,133797,,,,,,,450588,351868,566304,6387415,4926482,8085091,29496640,21727083,38682304,1.02443158248,0.902142645522,1.27241450858
2020-07-10,824,134621,,,,,,,450704,352195,566482,6460202,4994646,8167043,29947344,22079278,39248786,1.01710549087,0.899313611905,1.26259886753
2020-07-11,690,135311,,,,,,,450341,352238,566551,6522289,5053142,8236337,30397685,22431516,39815337,1.01025257948,0.898461909299,1.25179925501
2020-07-12,459,135770,,,,,,,449532,351546,565881,6574002,5102135,8293536,30847217,22783062,40381218,1.00390367014,0.897412651354,1.23797238908
2020-07-13,367,136137,,,,,,,448308,350395,564623,6615744,5141739,8339954,31295525,23133457,40945841,0.998072256211,0.895173218447,1.22346135041
2020-07-14,926,137063,,,,,,,446695,349244,563837,6647972,5173615,8377273,31742220,23482701,41509678,0.992751003791,0.894029218849,1.20661382496
2020-07-15,968,138031,,,,,,,444721,347916,561607,6671178,5197850,8403788,32186941,23830617,42071285,0.98791545525,0.893387934812,1.1868763272
2020-07-16,943,138974,,,,,,,442412,345650,558977,6685872,5213989,8420915,32629353,24176267,42630262,0.98353322406,0.892310178015,1.17714017172
2020-07-17,930,139904,,,,,,,439791,343310,555541,6692569,5222538,8428775,33069144,24519577,43185803,0.979572099325,0.891114750818,1.16040986214
2020-07-18,868,140772,,,,,,,436883,340179,552688,6691779,5223796,8429358,33506027,24859756,43738491,0.976002790103,0.89063685473,1.14403308633
2020-07-19,447,141219,,,,,,,433710,337103,549339,6684000,5218017,8422904,33939737,25196859,44287830,0.972797485464,0.890177678447,1.13207264031
2020-07-20,514,141733,,,,,,,430295,333595,546052,6669711,5205504,8409198,34370032,25530454,44833882,0.969927794163,0.888116378994,1.10512858192
2020-07-21,1107,142840,,,,,,,426659,330459,542023,6649373,5187469,8388650,34796691,25860913,45375905,0.967364026359,0.883664766104,1.08899777549
2020-07-22,1216,144056,,,,,,,422823,326926,537835,6623421,5164404,8362216,35219514,26187839,45913740,0.965075583873,0.879763102892,1.06854933837
2020-07-23,1094,145150,,,,,,,418805,323532,533678,6592268,5136636,8330608,35638319,26511371,46447418,0.963031705102,0.877105838298,1.05216623359
2020-07-24,1132,146282,,,,,,,414625,319855,529822,6556305,5104575,8294149,36052944,26831226,46977240,0.961202327699,0.87633276219,1.04496913793
2020-07-25,899,147181,,,,,,,410299,315441,526040,6515900,5067793,8253727,36463243,27146667,47503280,0.959559123255,0.875717336255,1.04086389696
2020-07-26,472,147653,,,,,,,405843,311005,522239,6471401,5026529,8209427,36869086,27457672,48025519,0.958076599252,0.875136451406,1.03969940012
2020-07-27,1120,148773,,,,,,,401273,306667,518074,6423142,4981627,8161638,37270359,27764339,48543593,0.956732957955,0.874465774826,1.03735590554
2020-07-28,1374,150147,,,,,,,396603,301879,513850,6371438,4933079,8110881,37666962,28066218,49057443,0.955510404854,0.873814766317,1.03400819161
2020-07-29,1432,151579,,,,,,,391846,297158,509794,6316589,4880960,8056857,38058808,28363376,49567237,0.954394790822,0.873362392877,1.02997578395
2020-07-30,1209,152788,,,,,,,387015,292358,505422,6258883,4825366,8000680,38445823,28655734,50072659,0.953374729134,0.872930078193,1.02820083846
2020-07-31,1243,154031,,,,,,,382121,287431,500649,6198592,4767107,7942377,38827944,28943165,50573308,0.952440517621,0.872513072122,1.02641099099
2020-08-01,1115,155146,,,,,,,377174,282532,496525,6135974,4706300,7883374,39205118,29225697,51069833,0.951583222158,0.87211006433,1.02571107691
2020-08-02,403,155549,,,,,,,372184,277721,492322,6071275,4643820,7823024,39577302,29503418,51562155,0.950794141912,0.871720004137,1.02444682121
2020-08-03,530,156079,,,,,,,367160,272706,487482,6004725,4579410,7761174,39944462,29776124,52049637,0.950064678085,0.871342038839,1.02337014928
2020-08-04,1378,157457,,,,,,,362111,267614,482658,5936541,4513422,7697784,40306573,30043738,52532295,0.949386481402,0.870975466892,1.022929965
2020-08-05,1376,158833,,,,,,,357045,262048,477934,5866927,4445007,7633680,40663618,30305786,53010229,0.948751709868,0.870619702398,1.02248964802
2020-08-06,1253,160086,,,,,,,351968,256914,472677,5796073,4374994,7568521,41015586,30562700,53482906,0.948153264828,0.870274558666,1.02204874896
2020-08-07,1242,161328,,,,,,,346889,251987,468344,5724156,4303453,7503177,41362475,30814687,53951250,0.947584938567,0.869940311035,1.02160693366
2020-08-08,1077,162405,,,,,,,341812,246953,463935,5651344,4230563,7437280,41704287,31061640,54415185,0.947041461772,0.86961553111,1.02116395563
2020-08-09,511,162916,,,,,,,336745,241886,459749,5577791,4157016,7370989,42041032,31303526,54874934,0.946518470123,0.86929988487,1.02033553865
2020-08-10,527,163443,,,,,,,331694,236852,455401,5503642,4082875,7304162,42372726,31540378,55330335,0.946012419176,0.868993070195,1.01977197948
2020-08-11,1064,164507,,,,,,,326664,231741,450825,5429032,4007957,7236924,42699390,31772119,55781160,0.945520474269,0.868694810124,1.01920600065
2020-08-12,1505,166012,,,,,,,321659,226511,445800,5354088,3932595,7168888,43021049,31998630,56226960,0.945040394971,0.868404847735,1.01863764263
2020-08-13,1070,167082,,,,,,,316685,221671,441161,5278927,3857104,7100274,43337734,32220301,56668121,0.94457042609,0.868122942254,1.01798482179
2020-08-14,1338,168420,,,,,,,311746,217006,436641,5203657,3781753,7031512,43649480,32437307,57104762,0.944109201348,0.867860852782,1.01732866512
2020-08-15,1034,169454,,,,,,,306844,212465,432076,5128381,3706790,6962963,43956324,32649772,57536838,0.943655661821,0.86765489309,1.01666919882
2020-08-16,571,170025,,,,,,,301985,207865,427043,5053192,3632126,6893510,44258309,32857637,57963881,0.94320898892,0.867416313388,1.01599998639
2020-08-17,446,170471,,,,,,,297169,203264,422172,4978177,3557670,6823385,44555478,33060901,58386053,0.942768550488,0.867069051733,1.01530295118
2020-08-18,1325,171796,,,,,,,292401,198732,417689,4903418,3483691,6753613,44847879,33259633,58803742,0.942333858106,0.866819470617,1.01467673232
2020-08-19,1353,173149,,,,,,,287682,194207,412761,4828988,3410278,6683736,45135561,33453840,59216503,0.941904533667,0.866576796902,1.01399076429
2020-08-20,1079,174228,,,,,,,283014,189977,407703,4754957,3338203,6613518,45418575,33643817,59624206,0.941480283432,0.86632387987,1.01330801667
2020-08-21,1105,175333,,,,,,,278398,185637,402632,4681387,3266923,6543496,45696973,33829454,60026838,0.941060878006,0.866069863269,1.01264512052
2020-08-22,982,176315,,,,,,,273836,181490,397620,4608334,3196423,6472791,45970809,34010944,60424458,0.940646136971,0.865823213143,1.01194021074
2020-08-23,450,176765,,,,,,,269329,177292,392769,4535850,3126760,6401645,46240138,34188236,60817227,0.940235917125,0.865583674879,1.01130525361
2020-08-24,442,177207,,,,,,,265143,173462,388208,4464248,3058329,6330124,46505281,34361698,61205435,0.940775021867,0.867500766066,1.01126086176
2020-08-25,1239,178446,,,,,,,261006,169845,383814,4393560,2991318,6258549,46766287,34531543,61589249,0.941321251266,0.869253462088,1.01110904195
2020-08-26,1225,179671,,,,,,,256931,166118,379998,4323827,2925691,6187736,47023218,34697661,61969247,0.94187414118,0.870816311938,1.01246281353
2020-08-27,1111,180782,,,,,,,252931,162461,375923,4255098,2861638,6117867,47276149,34860122,62345170,0.942433644741,0.871394534707,1.01338755055
2020-08-28,971,181753,,,,,,,249031,158868,372075,4187444,2798827,6048784,47525180,35018990,62717245,0.942999704931,0.872099938125,1.01396426844
2020-08-29,958,182711,,,,,,,245257,155409,368329,4120955,2737224,5980479,47770437,35174399,63085574,0.943572251797,0.872478235839,1.01616542512
2020-08-30,310,183021,,,,,,,241589,152132,364362,4055700,2676888,5912770,48012026,35326531,63449936,0.944151179622,0.871189382497,1.01828603827
2020-08-31,573,183594,,,,,,,238010,148894,360540,3991725,2617916,5846269,48250036,35475425,63810476,0.944736343005,0.871043789736,1.02051226291
2020-09-01,1067,184661,,,,,,,234519,145807,357367,3929074,2560456,5781471,48484555,35621232,64167843,0.94532763086,0.871007594202,1.02277892099
2020-09-02,1056,185717,,,,,,,231117,142877,354192,3867790,2504597,5717981,48715672,35764109,64522035,0.9459249582,0.870691265589,1.02453804176
2020-09-03,1070,186787,,,,,,,227812,140068,351084,3807920,2450453,5656307,48943484,35904177,64873119,0.9465282408,0.871176691392,1.02718347579
2020-09-04,965,187752,,,,,,,224603,137169,347837,3749509,2397641,5596444,49168087,36041346,65220956,0.947137392986,0.869120382484,1.02931665217
2020-09-05,783,188535,,,,,,,221486,134295,344725,3692598,2346295,5538541,49389573,36175641,65565681,0.947752313572,0.869056742536,1.03159851796
2020-09-06,403,188938,,,,,,,218458,131658,341922,3637220,2296459,5482845,49608031,36307299,65907603,0.948372901374,0.86977191212,1.03324068268
2020-09-07,267,189205,,,,,,,215518,129112,339396,3583409,2248274,5429458,49823549,36436411,66246999,0.948999060807,0.869802867871,1.03513289387
2020-09-08,,,745.221706096,530,1033,189950.221706,189735,190238,212666,126551,337477,3530932,2201360,5378696,50036215,36562962,66584476,0.949630699336,0.870549006414,1.03768217473
2020-09-09,,,737.217342839,522,1027,190687.439049,190258,191265,209902,124026,335389,3479828,2155540,5330242,50246117,36686988,66919865,0.950267723989,0.870634082896,1.04002214253
2020-09-10,,,729.157481912,513,1021,191416.596531,190772,192285,207226,121417,332721,3430123,2110842,5282942,50453343,36808405,67252586,0.950910037431,0.87010174728,1.04235707931
2020-09-11,,,721.060050408,504,1015,192137.656581,191276,193300,204636,119062,330640,3381829,2067446,5237640,50657979,36927467,67583226,0.951557539175,0.870104447125,1.04467959619
2020-09-12,,,712.943737224,495,1008,192850.600318,191772,194308,202131,116838,328442,3334929,2025420,5193995,50860110,37044305,67911668,0.952210128008,0.869185948322,1.0470504353
2020-09-13,,,704.825621975,487,1001,193555.42594,192259,195308,199710,114612,326464,3289382,1984628,5152121,51059820,37158917,68238132,0.952867702315,0.868126330042,1.0495908385
2020-09-14,,,696.719562576,479,994,194252.145503,192738,196302,197374,112423,324275,3245167,1944924,5112028,51257194,37271340,68562407,0.953530159403,0.866617670008,1.05197956594
2020-09-15,,,688.639739981,470,987,194940.785243,193209,197289,195121,110445,321958,3202278,1906482,5073444,51452315,37381785,68884365,0.954197394165,0.864548038355,1.05469608025
2020-09-16,,,680.600526716,462,980,195621.38577,193672,198268,192951,108509,319988,3160711,1869191,5036068,51645266,37490294,69204353,0.954869298676,0.862999537562,1.05709789642
2020-09-17,,,672.616138718,454,973,196294.001908,194127,199240,190864,106472,318158,3120458,1832789,5000033,51836130,37596766,69522511,0.955545762569,0.861804709823,1.060362404
2020-09-18,,,664.699985611,446,965,196958.701894,194573,200204,188859,104512,316557,3081505,1797236,4965505,52024989,37701278,69839068,0.956226673274,0.861204133403,1.06290396328
2020-09-19,,,656.861890757,438,958,197615.563785,195012,201161,186935,102574,314965,3043836,1762644,4932631,52211924,37803852,70154033,0.956911915908,0.861028058239,1.06431035776
2020-09-20,,,649.111712172,431,950,198264.675497,195444,202111,185092,100672,314173,3007442,1729023,4902083,52397016,37904524,70468206,0.957601372846,0.859940894907,1.06720158407
2020-09-21,,,641.459407413,423,943,198906.134904,195867,203053,183331,98760,314023,2972315,1696124,4874192,52580347,38003284,70782229,0.958294923347,0.857854560442,1.07025592723
2020-09-22,,,631.618067731,414,932,199537.752972,196281,203984,181651,96946,313530,2938448,1663955,4848324,52761998,38100230,71095759,0.958992443409,0.856319357672,1.07358315134
2020-09-23,,,621.966338979,405,922,200159.719311,196686,204905,180051,95172,313214,2905834,1632571,4824050,52942049,38195402,71408973,0.959693805709,0.854224816956,1.07646235204
2020-09-24,,,612.505899446,396,913,200772.225211,197083,205817,178532,93406,313055,2874464,1601944,4801715,53120581,38288808,71722028,0.960398879481,0.852140282307,1.07875027034
2020-09-25,,,603.239055377,387,903,201375.464266,197471,206720,177093,91673,313166,2844331,1572193,4782168,53297674,38380481,72035194,0.961107530274,0.850177244281,1.08033638948
2020-09-26,,,594.168550304,379,894,201969.632816,197851,207613,175735,90071,313609,2815429,1543194,4765150,53473409,38470552,72348803,0.961819619674,0.848444362031,1.08463975045
2020-09-27,,,585.297239984,371,885,202554.930056,198222,208497,174457,88503,314377,2787756,1514852,4751101,53647866,38559055,72663180,0.962535005058,0.846390341791,1.08799392787
2020-09-28,,,576.627521293,363,877,203131.557578,198586,209373,173260,87004,315519,2761306,1487238,4740168,53821126,38646059,72978699,0.963253539372,0.844429568428,1.0911861165
2020-09-29,,,568.160694975,356,869,203699.718272,198943,210241,172144,85530,317082,2736076,1460342,4732975,53993270,38731589,73295781,0.963975070913,0.842477495699,1.0943761455
2020-09-30,,,559.897567599,348,861,204259.61584,199291,211102,171109,84025,318708,2712064,1433923,4729718,54164379,38815614,73614489,0.964699443076,0.840348212134,1.09774501092
2020-10-01,,,551.838893868,341,854,204811.454734,199633,211954,170156,82555,319990,2689269,1407971,4729710,54334535,38898169,73934479,0.965433690797,0.839962026262,1.1012680718
2020-10-02,,,543.985416096,334,846,205355.44015,199967,212799,169286,81139,320996,2667692,1382640,4732527,54503821,38979308,74255475,0.96617365443,0.837781066398,1.1039761022
2020-10-03,,,536.337846888,327,838,205891.777997,200295,213637,168498,79874,323618,2647331,1358006,4739563,54672319,39059182,74579093,0.966916112931,0.835886712922,1.10667532207
2020-10-04,,,528.89654919,320,831,206420.674546,200616,214467,167794,78584,326299,2628191,1334018,4750869,54840113,39137766,74905392,0.967664494732,0.834305645665,1.11040715278
2020-10-05,,,521.661598222,313,826,206942.336144,200930,215292,167174,77446,329135,2610272,1310796,4765802,55007287,39215212,75234527,0.96842110321,0.832730532793,1.11363955349
2020-10-06,,,514.632921303,307,820,207456.969066,201238,216111,166639,76345,332047,2593580,1288383,4783808,55173926,39291557,75566574,0.969181363936,0.831161279611,1.11686612519
2020-10-07,,,507.810386941,301,814,207964.779453,201540,216923,166190,75072,334367,2578119,1266512,4804634,55340116,39366629,75900941,0.969943137499,0.829490180692,1.12008599061
2020-10-08,,,501.193827386,295,807,208465.97328,201835,217730,165828,73844,337864,2563896,1245186,4829279,55505944,39440473,76238805,0.970706854714,0.827872632075,1.12329822595
2020-10-09,,,494.782875233,289,802,208960.756155,202125,218530,165553,72661,342273,2550917,1224443,4858499,55671497,39513134,76581078,0.971479444129,0.826066101687,1.12837413023
2020-10-10,,,488.576961912,283,796,209449.333117,202409,219325,165368,71624,346560,2539192,1204395,4891893,55836865,39584758,76927638,0.972261466338,0.82451374273,1.13190694763
2020-10-11,,,482.575354493,278,791,209931.908472,202688,220115,165273,70519,350693,2528730,1184841,4928982,56002138,39655277,77278331,0.973047119707,0.823085312854,1.13534672736
2020-10-12,,,476.777191738,272,786,210408.685663,202961,220900,165270,69536,355716,2519544,1165870,4970328,56167408,39724813,77634047,0.973834277203,0.822524304784,1.1374901874
2020-10-13,,,471.181617788,268,781,210879.867281,203229,221679,165361,68474,361093,2511644,1147337,5015904,56332769,39793287,77995140,0.974625535045,0.821469768217,1.14245954649
2020-10-14,,,465.787873039,262,776,211345.655154,203493,222454,165546,67509,365676,2505046,1129314,5064505,56498315,39860796,78360816,0.975423020057,0.82139054684,1.14700559448
2020-10-15,,,460.595150364,258,772,211806.250305,203751,223225,165828,66579,371011,2499765,1111866,5116815,56664143,39927375,78731827,0.976242271118,0.821363285286,1.14981586418
2020-10-16,,,455.602609197,253,767,212261.852914,204005,223990,166209,65637,376399,2495818,1094947,5173228,56830352,39993012,79108226,0.97706597151,0.820695087864,1.15247224793
2020-10-17,,,450.809410558,248,763,212712.662324,204254,224752,166690,64794,382739,2493222,1078601,5234966,56997042,40057806,79490965,0.977889531841,0.819844523352,1.15577863145
2020-10-18,,,446.214766134,244,761,213158.87709,204499,225511,167274,63842,388857,2491998,1062569,5300204,57164316,40121648,79879822,0.978712832232,0.819462379847,1.15962248765
2020-10-19,,,441.818085566,240,760,213600.695176,204740,226269,167963,63022,396036,2492167,1047007,5369942,57332279,40184670,80275858,0.979538670499,0.818309247503,1.16341974553
2020-10-20,,,437.618842327,235,759,214038.314018,204976,227026,168759,62061,403431,2493752,1031621,5444234,57501038,40246731,80679289,0.980368402194,0.817250589799,1.16637768217
2020-10-21,,,433.616576665,231,757,214471.930595,205207,227782,169666,61117,411563,2496779,1016393,5523740,57670704,40307848,81090852,0.981200948767,0.818368986347,1.16930000347
2020-10-22,,,429.810908772,227,757,214901.741504,205435,228537,170684,60311,420169,2501273,1001633,5609531,57841388,40368159,81511021,0.982048589436,0.817900560862,1.17320744825
2020-10-23,,,426.201569833,222,757,215327.943074,205658,229291,171819,59519,429107,2507264,987309,5700766,58013207,40427678,81940128,0.982896491728,0.816953125506,1.17716441347
2020-10-24,,,422.788669718,218,757,215750.731743,205877,230046,173071,58816,438272,2514782,973465,5796768,58186278,40486494,82378400,0.983742749268,0.817474808121,1.17895553524
2020-10-25,,,419.572436747,214,758,216170.30418,206092,230802,174445,58168,447704,2523859,960008,5897910,58360723,40544662,82826104,0.98458775629,0.816959944804,1.1824742204
2020-10-26,,,416.553227806,210,761,216586.857408,206304,231561,175944,57436,456913,2534530,946926,6004122,58536667,40602098,83283017,0.985434390392,0.816883310218,1.18606567222
2020-10-27,,,413.731543751,207,764,217000.588952,206512,232323,177571,56782,466882,2546831,934171,6115287,58714238,40658880,83749899,0.98627637567,0.816613265221,1.18963761281
2020-10-28,,,411.108064236,203,768,217411.697016,206716,233089,179330,56143,478315,2560801,921839,6232508,58893568,40715023,84228214,0.987115282016,0.816026918531,1.19204653451
2020-10-29,,,408.683687559,200,771,217820.380703,206917,233857,181225,55497,490081,2576480,909827,6356918,59074793,40770520,84718295,0.98795399794,0.81529699618,1.19579210149
2020-10-30,,,406.459517854,196,773,218226.840221,207115,234627,183259,54930,502444,2593911,898176,6488362,59258052,40825450,85220739,0.988793676439,0.814818604669,1.19966212028
2020-10-31,,,404.436853876,193,777,218631.277075,207309,235402,185436,54416,515447,2613138,886953,6627413,59443488,40879866,85736186,0.989628145605,0.813597557239,1.20361535595
2020-11-01,,,402.617187069,190,784,219033.894262,207500,236183,187761,53818,529753,2634209,875974,6774434,59631249,40933684,86265939,0.990457085672,0.812430081768,1.20703370829
