date,actual_deaths,total_deaths,predicted_deaths_mean,predicted_deaths_lower,predicted_deaths_upper,predicted_total_deaths_mean,predicted_total_deaths_lower,predicted_total_deaths_upper,predicted_new_infected_mean,predicted_new_infected_lower,predicted_new_infected_upper,predicted_current_infected_mean,predicted_current_infected_lower,predicted_current_infected_upper,predicted_total_infected_mean,predicted_total_infected_lower,predicted_total_infected_upper,r_values_mean,r_values_lower,r_values_upper
2020-02-05,0,0,,,,,,,125,65,178,125,65,178,125,65,178,2.25024667488,2.1,2.4
2020-02-06,0,0,,,,,,,125,65,178,249,130,356,250,130,356,2.2502374409,2.09998891478,2.39999965106
2020-02-07,0,0,,,,,,,125,65,178,374,195,534,375,195,534,2.25023430754,2.0999853813,2.39999947321
2020-02-08,0,0,,,,,,,125,65,178,498,260,712,500,260,712,2.25023009839,2.09998072923,2.39999920555
2020-02-09,0,0,,,,,,,287,164,406,786,438,1104,787,424,1118,2.25022443911,2.09997459758,2.39999879849
2020-02-10,0,0,,,,,,,287,164,406,1073,607,1504,1074,588,1524,2.25021682312,2.09996579594,2.3999981818
2020-02-11,0,0,,,,,,,287,164,406,1361,774,1907,1361,752,1930,2.25020656404,2.09995426818,2.39999728737
2020-02-12,0,0,,,,,,,287,164,406,1648,940,2310,1648,916,2336,2.2501927308,2.09993885533,2.39999595863
2020-02-13,0,0,,,,,,,470,281,651,2118,1241,2941,2118,1197,2987,2.25017405876,2.09991824813,2.39999388205
2020-02-14,0,0,,,,,,,674,410,926,2792,1656,3862,2792,1607,3913,2.25011986481,2.09985955892,2.39996501876
2020-02-15,0,0,,,,,,,1206,748,1618,3998,2459,5439,3998,2355,5531,2.25008211328,2.09981868672,2.39995726676
2020-02-16,0,0,,,,,,,2399,1466,3090,6397,4053,8465,6397,3821,8621,2.25002413045,2.09975733735,2.39993931384
2020-02-17,0,0,,,,,,,3864,2490,4911,10261,6676,13283,10261,6311,13532,2.24994973178,2.09967941393,2.39991760552
2020-02-18,0,0,,,,,,,4279,2802,5445,14540,9518,18700,14540,9113,18977,2.24985203678,2.09957849616,2.39988832854
2020-02-19,0,0,,,,,,,5036,3362,6389,19575,12944,25046,19576,12475,25366,2.24972196592,2.09944623734,2.39984774346
2020-02-20,0,0,,,,,,,5172,3466,6576,24623,16356,31437,24748,15941,31942,2.24954639142,2.09927078948,2.39978889273
2020-02-21,0,0,,,,,,,5701,3879,7239,30200,20195,38479,30449,19820,39181,2.24930780753,2.0990371087,2.39970190983
2020-02-22,0,0,,,,,,,6780,4690,8611,36855,24866,46875,37229,24510,47792,2.24898608428,2.09872834375,2.39957578997
2020-02-23,0,0,,,,,,,8117,5701,10292,44848,30596,56913,45346,30211,58084,2.24855224223,2.09832100516,2.39939228378
2020-02-24,0,0,,,,,,,10298,7222,13144,54858,37734,69593,55644,37433,71228,2.24796480202,2.09778248542,2.39912393071
2020-02-25,0,0,,,,,,,16139,10792,20587,70710,48538,89661,71783,48225,91815,2.24716667823,2.09706943245,2.39875767303
2020-02-26,0,0,,,,,,,19444,13256,24866,89867,61673,114089,91227,61481,116681,2.24607917481,2.09612931516,2.398222474
2020-02-27,0,0,,,,,,,21199,14338,27301,110778,75861,140971,112426,75819,143982,2.24459557072,2.09489008459,2.39745609861
2020-02-28,0,0,,,,,,,25780,17260,33511,136089,92839,173821,138206,93079,177493,2.24256896562,2.0932333619,2.39635214616
2020-02-29,1,1,,,,,,,31489,20577,41618,166904,113017,214468,169695,113656,219111,2.23979665854,2.09103617992,2.3947580361
2020-03-01,0,1,,,,,,,40847,26124,54591,206544,138458,267323,210542,139780,273702,2.23600029196,2.08812265068,2.39246983501
2020-03-02,5,6,,,,,,,50723,32125,68267,254868,169227,332350,261265,171905,341969,2.23079979147,2.08425202483,2.38916729179
2020-03-03,1,7,,,,,,,62840,39594,84832,313844,206420,412130,324105,211499,426801,2.22368042282,2.07909079469,2.38433656851
2020-03-04,4,11,,,,,,,76948,47814,104020,386514,251526,510571,401053,259313,530821,2.21395191853,2.07168953419,2.37738188938
2020-03-05,1,12,,,,,,,95957,59146,130555,477435,307396,634573,497010,318459,661376,2.20070269376,2.06196474665,2.36883525139
2020-03-06,2,14,,,,,,,117119,71804,159878,589382,375816,787704,614129,390263,821254,2.18275724515,2.0474033567,2.3571075218
2020-03-07,3,17,,,,,,,140773,86605,193851,724454,458573,974101,754902,476868,1015105,2.1586528091,2.02424212668,2.33868137265
2020-03-08,4,21,,,,,,,166278,104518,229521,883951,558350,1194866,921180,581386,1244626,2.12666464095,1.98524132486,2.31243769365
2020-03-09,1,22,,,,,,,192858,125312,264204,1068693,677813,1448788,1114038,706698,1508830,2.08492323414,1.92505574817,2.27544839872
2020-03-10,6,28,,,,,,,219584,149317,298603,1277979,819642,1734293,1333622,856015,1807433,2.03167116151,1.85753430474,2.23927640476
2020-03-11,5,33,,,,,,,243066,169650,323931,1504905,978464,2037634,1576688,1025665,2131364,1.96567802451,1.77647373606,2.19375128219
2020-03-12,10,43,,,,,,,262203,184763,343731,1747663,1149857,2356569,1838891,1210428,2475095,1.88674830223,1.67655684597,2.14237008648
2020-03-13,9,52,,,,,,,277168,197503,365134,2003632,1332944,2694420,2116059,1407931,2840229,1.79614250662,1.57074498825,2.0912006388
2020-03-14,6,58,,,,,,,287843,205253,381853,2265695,1520911,3042729,2403902,1613184,3222082,1.69668414373,1.45039894881,2.04156039082
2020-03-15,12,70,,,,,,,295449,211887,396205,2529655,1712347,3397220,2699351,1825071,3618287,1.59243712252,1.32864519877,1.96392638628
2020-03-16,27,97,,,,,,,300197,217675,406578,2789005,1904188,3749081,2999548,2042746,4024865,1.48805243014,1.21884923698,1.88354636327
2020-03-17,35,132,,,,,,,302758,222065,408976,3041040,2094626,4089637,3302306,2264811,4433841,1.38802365559,1.12731385461,1.78225650931
2020-03-18,59,191,,,,,,,303820,226049,409201,3282020,2281768,4413800,3606126,2490860,4843042,1.29607405393,1.05561208346,1.66437963062
2020-03-19,77,268,,,,,,,303801,229211,407630,3508872,2464039,4717113,3909927,2720071,5250672,1.21478696084,1.00386281913,1.54439699506
2020-03-20,99,367,,,,,,,303117,231482,404106,3716032,2637435,4990145,4213044,2951553,5654778,1.14548674637,0.966121961646,1.43008942313
2020-03-21,95,462,,,,,,,301850,233065,399554,3900763,2799814,5229133,4514894,3184618,6054332,1.08832756894,0.940985525399,1.33588774928
2020-03-22,148,610,,,,,,,300083,234118,395145,4060074,2948449,5429657,4814977,3418736,6449477,1.04253488061,0.923043523445,1.25256150258
2020-03-23,187,797,,,,,,,297950,234665,390474,4191746,3079624,5589825,5112927,3653401,6839951,1.00673303149,0.908900661767,1.1785906521
2020-03-24,242,1039,,,,,,,295499,234434,382952,4294386,3189668,5707578,5408426,3887835,7222903,0.979277863181,0.891181056976,1.11519878373
2020-03-25,316,1355,,,,,,,292779,234117,375630,4367582,3275542,5783644,5701205,4121952,7598533,0.958522676896,0.877552677636,1.068284612
2020-03-26,422,1777,,,,,,,289799,232719,369281,4414315,3339414,5827751,5991004,4354671,7967814,0.942984605541,0.867326475263,1.02635872615
2020-03-27,561,2338,,,,,,,286551,229618,363138,4438663,3384501,5845786,6277555,4584289,8330952,0.931419036147,0.85892984886,1.00267770534
2020-03-28,654,2992,,,,,,,283046,226491,357492,4444541,3413315,5837049,6560601,4810780,8688444,0.922830288641,0.852992138772,0.982974594355
2020-03-29,634,3626,,,,,,,279322,223671,351982,4436020,3431125,5806471,6839923,5034451,9040426,0.916447692695,0.848741189487,0.97161055353
2020-03-30,834,4460,,,,,,,275333,220674,345843,4415904,3439054,5755995,7115256,5255125,9386269,0.911688116841,0.84547620863,0.962659380381
2020-03-31,1255,5715,,,,,,,271127,216630,339553,4386834,3436766,5689365,7386383,5471755,9725822,0.908117113475,0.843300956799,0.957008405851
2020-04-01,1268,6983,,,,,,,266722,212460,333015,4350798,3425792,5614064,7653105,5684215,10058837,0.905414371827,0.841961552713,0.952749179811
2020-04-02,1613,8596,,,,,,,262143,208059,326494,4309122,3406412,5532245,7915248,5892274,10385331,0.903345353294,0.840623074534,0.949330579168
2020-04-03,1337,9933,,,,,,,257418,203569,320350,4262739,3379542,5446062,8172666,6095843,10705681,0.901739070618,0.839743347049,0.946617794072
2020-04-04,1327,11260,,,,,,,252569,199333,314485,4212191,3346389,5357608,8425235,6295176,11020166,0.900471185608,0.838947216446,0.944829251146
2020-04-05,1502,12762,,,,,,,247631,194891,308473,4157971,3307467,5267723,8672866,6490067,11328639,0.899451395589,0.838310941798,0.943273221343
2020-04-06,1739,14501,,,,,,,242635,190664,302569,4100523,3263508,5176410,8915501,6680731,11631208,0.898614137265,0.837635475065,0.942124538284
2020-04-07,2379,16880,,,,,,,237615,186301,296378,4040188,3214825,5083558,9153116,6867032,11927586,0.897911790919,0.837017284234,0.941220473309
2020-04-08,2182,19062,,,,,,,232600,181929,290594,3977290,3162150,4992170,9385716,7048961,12218180,0.897309738036,0.836365436802,0.940445021248
2020-04-09,2151,21213,,,,,,,227616,177479,284700,3912126,3105420,4901961,9613332,7226440,12502880,0.896782778205,0.835971415459,0.939735085693
2020-04-10,2146,23359,,,,,,,222685,173043,278781,3845013,3045644,4811981,9836017,7399483,12781661,0.896312536076,0.835655133137,0.939287963512
2020-04-11,2124,25483,,,,,,,217825,168812,272771,3776286,2984745,4721983,10053842,7568295,13054432,0.89588310875,0.835284492892,0.938852654748
2020-04-12,1853,27336,,,,,,,213047,164731,267209,3706288,2922902,4631962,10266889,7733026,13321641,0.895488103754,0.83477513728,0.938446044063
2020-04-13,1906,29242,,,,,,,208361,160779,261611,3635326,2859933,4541749,10475250,7893805,13583252,0.89511890183,0.834331668919,0.938089397881
2020-04-14,2457,31699,,,,,,,203773,156963,256023,3563767,2796134,4451998,10679023,8050768,13839275,0.89477278862,0.833925079594,0.937800915996
2020-04-15,2609,34308,,,,,,,199285,153169,250661,3491925,2732616,4363108,10878308,8203937,14089936,0.894449198254,0.833661501304,0.937514307409
2020-04-16,2175,36483,,,,,,,194898,149398,245350,3420101,2669536,4275415,11073206,8353335,14335286,0.894138858791,0.833411995385,0.937223247881
2020-04-17,2666,39149,,,,,,,190612,145741,240346,3348570,2607228,4189254,11263818,8499076,14575632,0.893844626353,0.833124724891,0.936938179436
2020-04-18,2445,41594,,,,,,,186426,142121,235466,3277578,2545808,4104390,11450244,8641197,14811098,0.893563058552,0.832939001774,0.936658394408
2020-04-19,1276,42870,,,,,,,182337,138743,230670,3207346,2485248,4020623,11632581,8779940,15041768,0.893295337725,0.832704525951,0.93637354563
2020-04-20,1834,44704,,,,,,,178344,135489,226090,3138059,2425874,3938317,11810925,8915429,15267858,0.893041444986,0.832528625147,0.936072528001
2020-04-21,2504,47208,,,,,,,174444,132106,221542,3069868,2367329,3857372,11985369,9047535,15489400,0.892801016718,0.832321161629,0.935798649652
2020-04-22,2431,49639,,,,,,,170635,128842,217343,3002888,2309867,3778423,12156004,9176377,15706743,0.892575635521,0.832120658485,0.935588902383
2020-04-23,2466,52105,,,,,,,166916,125706,213231,2937204,2253630,3701149,12322920,9302083,15919974,0.892367971381,0.832006733041,0.935309421412
2020-04-24,2154,54259,,,,,,,163286,122662,209265,2872874,2198786,3625804,12486206,9424745,16129239,0.892181754855,0.831936848153,0.935101878329
2020-04-25,1697,55956,,,,,,,159744,119523,205482,2809932,2145234,3552593,12645950,9544268,16334721,0.892022047321,0.831847369935,0.934891690749
2020-04-26,1330,57286,,,,,,,156289,116520,201761,2748396,2092910,3481661,12802239,9660788,16536482,0.891895956018,0.831845211338,0.934710553032
2020-04-27,1467,58753,,,,,,,152920,113589,198027,2688269,2041737,3412547,12955159,9774377,16734509,0.891812817498,0.831819566212,0.934472158142
2020-04-28,2241,60994,,,,,,,149635,110724,194458,2629543,1991655,3345446,13104794,9885101,16928967,0.891785374038,0.831859055092,0.934245833259
2020-04-29,2521,63515,,,,,,,146437,108032,191028,2572207,1942699,3280481,13251231,9993133,17119995,0.891830655266,0.831918465717,0.93413965001
2020-04-30,2324,65839,,,,,,,143324,105261,187686,2516246,1894773,3217523,13394555,10098394,17307681,0.891971126136,0.8319678995,0.934078007971
2020-05-01,1891,67730,,,,,,,140301,102569,184409,2461649,1847931,3156591,13534856,10200963,17492090,0.892236223402,0.83201545042,0.933943411493
2020-05-02,1692,69422,,,,,,,137365,99882,181168,2408401,1802061,3097415,13672221,10300845,17673258,0.892664013248,0.832069199988,0.93420554761
2020-05-03,1121,70543,,,,,,,134520,97303,178085,2356495,1757239,3040036,13806741,10398148,17851343,0.893302757296,0.832070618391,0.934771178913
2020-05-04,1333,71876,,,,,,,131770,94834,175171,2305928,1713327,2984534,13938511,10492982,18026514,0.894212115288,0.831960872141,0.935649549153
2020-05-05,2318,74194,,,,,,,129118,92379,172306,2256702,1670215,2930744,14067629,10585361,18198820,0.895463198094,0.832131850438,0.93714073794
2020-05-06,2363,76557,,,,,,,126570,90032,169516,2208829,1628140,2878711,14194199,10675393,18368336,0.897136522086,0.832253304503,0.940556368502
2020-05-07,1936,78493,,,,,,,124131,87763,166844,2162324,1587062,2828202,14318330,10763156,18535180,0.899316783027,0.832602742591,0.953698281219
2020-05-08,1747,80240,,,,,,,121808,85658,164336,2117216,1547014,2779296,14440138,10848814,18699516,0.902083973589,0.83348425772,0.969596515652
2020-05-09,1488,81728,,,,,,,119609,83623,161968,2073539,1507976,2731988,14559747,10932437,18861484,0.905502166651,0.83447788115,0.988693137071
2020-05-10,894,82622,,,,,,,117545,81655,159767,2031340,1470110,2686263,14677292,11014092,19021251,0.909610064162,0.835279441644,1.01360583771
2020-05-11,1015,83637,,,,,,,115627,79896,157749,1990678,1433488,2642242,14792919,11093988,19179000,0.914419100188,0.836544229195,1.03077202117
2020-05-12,1626,85263,,,,,,,113869,78258,155913,1951627,1398156,2600121,14906788,11172246,19334913,0.91992217969,0.838423717624,1.05988603652
2020-05-13,1763,87026,,,,,,,112284,76829,154276,1914275,1364261,2559934,15019072,11249075,19489189,0.926108765589,0.840787532641,1.09106114097
2020-05-14,1783,88809,,,,,,,110887,75504,152777,1878726,1331732,2521682,15129959,11324579,19641966,0.932976384896,0.84380487025,1.11704877238
2020-05-15,1681,90490,,,,,,,109695,74383,151736,1845097,1300857,2485726,15239654,11398962,19793702,0.940532026393,0.84725186422,1.1391873097
2020-05-16,1216,91706,,,,,,,108721,73357,150900,1813517,1271650,2452208,15348375,11472319,19944602,0.948786568736,0.852538966246,1.15842962815
2020-05-17,758,92464,,,,,,,107980,72549,150295,1784132,1244327,2421321,15456355,11544868,20094897,0.957749501469,0.858252965713,1.17386979879
2020-05-18,776,93240,,,,,,,107485,71892,149932,1757098,1218931,2393153,15563840,11616760,20244829,0.967424344816,0.865606838961,1.18751016504
2020-05-19,1555,94795,,,,,,,107251,71483,149810,1732579,1195601,2367774,15671091,11688243,20394639,0.977796885044,0.874429890077,1.19967648266
2020-05-20,1579,96374,,,,,,,107289,71326,150042,1710750,1174575,2345483,15778380,11759569,20544681,0.988812571134,0.875562929304,1.21279767068
2020-05-21,1234,97608,,,,,,,107610,71337,150508,1691790,1155916,2326449,15885990,11830906,20695189,1.00035442515,0.875968329777,1.23681943423
2020-05-22,1273,98881,,,,,,,108225,71624,151518,1675884,1139819,2311089,15994215,11902530,20846707,1.01224185045,0.877070779797,1.24769835293
2020-05-23,1130,100011,,,,,,,109145,72115,152776,1663221,1126328,2299496,16103360,11974645,20999483,1.02426097685,0.877246062564,1.25443955894
2020-05-24,614,100625,,,,,,,110380,72970,154376,1653992,1115732,2291869,16213740,12047615,21153859,1.03621511536,0.877599898337,1.25783043892
2020-05-25,523,101148,,,,,,,111940,74106,156385,1648388,1108243,2288451,16325680,12121721,21310244,1.04796839533,0.87827641322,1.2633616004
2020-05-26,695,101843,,,,,,,113845,75479,158676,1646605,1103886,2289343,16439525,12197200,21468920,1.05945968781,0.879624216787,1.2693473148
2020-05-27,1518,103361,,,,,,,116105,77177,161531,1648841,1102862,2294932,16555630,12274377,21630451,1.07068468991,0.880579631978,1.28014887623
2020-05-28,1192,104553,,,,,,,118727,79040,164680,1655284,1105135,2305316,16674357,12353417,21795131,1.08166253519,0.882217757124,1.30343560352
2020-05-29,1171,105724,,,,,,,121725,81277,168604,1666122,1110968,2321123,16796082,12434694,21963735,1.09241201751,0.88454236918,1.30716155169
2020-05-30,979,106703,,,,,,,125114,83984,172827,1681541,1120621,2342191,16921196,12518678,22136562,1.10297024646,0.887890691034,1.31081487118
2020-05-31,591,107294,,,,,,,128912,86826,177476,1701732,1134134,2368729,17050108,12605504,22314038,1.11336043877,0.892719781853,1.3120578272
2020-06-01,777,108071,,,,,,,133141,90076,182751,1726892,1151696,2401142,17183249,12695580,22496789,1.12359703786,0.899652284344,1.31259920539
2020-06-02,1043,109114,,,,,,,137815,93653,188726,1757222,1173480,2439879,17321064,12789233,22685515,1.13363487801,0.909072653254,1.31294229094
2020-06-03,1011,110125,,,,,,,142957,97596,195452,1792929,1199607,2485446,17464021,12886829,22880967,1.14337498527,0.921645189032,1.31548344283
2020-06-04,1023,111148,,,,,,,148586,101906,202798,1834226,1230190,2538110,17612607,12988735,23083765,1.15265654831,0.930486719654,1.32268140285
2020-06-05,949,112097,,,,,,,154721,106662,211186,1881337,1265516,2598680,17767328,13095397,23294951,1.16133110115,0.935999012968,1.3339742944
2020-06-06,687,112784,,,,,,,161381,111788,219760,1934493,1305677,2666818,17928709,13207185,23514711,1.16928682706,0.940674637061,1.34238809052
2020-06-07,447,113231,,,,,,,168586,117337,228957,1993934,1350896,2742910,18097295,13324522,23743668,1.1764319842,0.946886564369,1.34780348721
2020-06-08,513,113744,,,,,,,176352,123235,238633,2059906,1401154,2827094,18273647,13447757,23982301,1.18273441405,0.95718626737,1.34718567315
2020-06-09,945,114689,,,,,,,184693,129748,249168,2132659,1456790,2919821,18458340,13577505,24231469,1.1881550035,0.968361327383,1.34927288071
2020-06-10,918,115607,,,,,,,193615,136660,260484,2212429,1517951,3021571,18651955,13714165,24491953,1.19269550942,0.984636323421,1.34995061236
2020-06-11,888,116495,,,,,,,203120,144156,272212,2299444,1584910,3132230,18855075,13858321,24764165,1.19636287183,1.0078714509,1.35118117146
2020-06-12,832,117327,,,,,,,213200,152126,285293,2393917,1657972,3252848,19068275,14010447,25049458,1.19915793568,1.03307719292,1.35270715453
2020-06-13,763,118090,,,,,,,223838,160493,299095,2496031,1737166,3383345,19292113,14170940,25348553,1.20109514484,1.05547782591,1.35549272442
2020-06-14,308,118398,,,,,,,235003,169290,313165,2605921,1822450,3523724,19527116,14340230,25661718,1.20214053258,1.05464148228,1.35485082104
2020-06-15,391,118789,,,,,,,246651,178557,328212,2723660,1914162,3674527,19773767,14518787,25989930,1.20229775565,1.05297796493,1.35623391624
2020-06-16,843,119632,,,,,,,258722,188009,342427,2849241,2012094,3834302,20032489,14706796,26332357,1.20153954813,1.04333688546,1.35607248424
2020-06-17,752,120384,,,,,,,271141,197554,357463,2982567,2115999,4003132,20303630,14904350,26689820,1.19986095403,1.03688286108,1.35714431664
2020-06-18,710,121094,,,,,,,283818,207645,373228,3123428,2226054,4180993,20587448,15111995,27063048,1.1972685855,1.02853516352,1.35804620552
2020-06-19,672,121766,,,,,,,296649,218045,388514,3271491,2342190,4366767,20884097,15330040,27451562,1.19375587511,1.0178349668,1.35795457316
2020-06-20,613,122379,,,,,,,309518,228847,404283,3426288,2464351,4559897,21193615,15558887,27855845,1.18934338893,1.0058339797,1.35667152894
2020-06-21,284,122663,,,,,,,322299,239942,418999,3587206,2592479,4759140,21515914,15798829,28274844,1.18403954452,0.996696775558,1.35690831054
2020-06-22,387,123050,,,,,,,334865,250511,433333,3753485,2725612,4963497,21850779,16049340,28708177,1.17794162447,0.987276847562,1.35696470406
2020-06-23,847,123897,,,,,,,347092,261082,447638,3924225,2863415,5172465,22197871,16310422,29155815,1.17115598857,0.982557673675,1.35558013696
2020-06-24,764,124661,,,,,,,358869,272016,461346,4098401,3005654,5384594,22556740,16582438,29617161,1.16379950011,0.977530478655,1.35434842445
2020-06-25,559,125220,,,,,,,370096,282291,473701,4274882,3151277,5597721,22926836,16864729,30090862,1.15599257812,0.973253337346,1.35307948567
2020-06-26,612,125832,,,,,,,380692,292565,485377,4452454,3299709,5810809,23307528,17157294,30576239,1.14782066754,0.966814327937,1.35121858961
2020-06-27,500,126332,,,,,,,390590,301991,495282,4629844,3449645,6020756,23698118,17459285,31071521,1.13938530342,0.958478649321,1.35087763751
2020-06-28,251,126583,,,,,,,399738,311119,504900,4805744,3600386,6226554,24097856,17770404,31576421,1.13075909165,0.951102754292,1.34868430217
2020-06-29,364,126947,,,,,,,408094,319365,514521,4978834,3750594,6427902,24505950,18089769,32090942,1.12201162081,0.945868321911,1.34562170887
2020-06-30,735,127682,,,,,,,415627,325859,523275,5147810,3898005,6622985,24921577,18415628,32614217,1.11319061487,0.94230679981,1.34013481035
2020-07-01,687,128369,,,,,,,422321,332091,530532,5311409,4042177,6811093,25343898,18747719,33144749,1.10430473907,0.938910020469,1.33323184036
2020-07-02,724,129093,,,,,,,428173,337014,536499,5468441,4181715,6990194,25772071,19084733,33681248,1.09535544395,0.935748216379,1.32460919909
2020-07-03,653,129746,,,,,,,433194,340908,541553,5617817,4315010,7158595,26205265,19425641,34222801,1.08632443889,0.932338618685,1.31389816493
2020-07-04,271,130017,,,,,,,437405,344226,546064,5758572,4441165,7316204,26642670,19769867,34768865,1.07722276104,0.928645271132,1.30800216855
2020-07-05,299,130316,,,,,,,440836,346948,549475,5889890,4559191,7461460,27083506,20116815,35318340,1.06809499781,0.925947178314,1.30518884672
2020-07-06,351,130667,,,,,,,443525,349165,551774,6011117,4668283,7594274,27527031,20465980,35870114,1.05902221533,0.922289411862,1.30081386027
2020-07-07,1224,131891,,,,,,,445513,350958,554169,6121765,4768566,7715131,27972544,20816938,36424283,1.05010553795,0.918030221606,1.29039924501
2020-07-08,850,132741,,,,,,,446842,352250,555474,6221515,4859575,7822971,28419386,21169188,36979757,1.04144994037,0.914908405557,1.28044714786
2020-07-09,1012,133753,,,,,,,447558,352944,556525,6310204,4940373,7918133,28866944,21522132,37536282,1.03314451115,0.912641497167,1.27270179218
2020-07-10,830,134583,,,,,,,447705,352839,556966,6387814,5010844,8001364,29314649,21874971,38093248,1.02525608548,0.91037286873,1.26285270914
2020-07-11,691,135274,,,,,,,447327,352255,557474,6454449,5070491,8073437,29761976,22227226,38650722,1.01783374783,0.908234414701,1.25107396313
2020-07-12,451,135725,,,,,,,446467,351272,557407,6510326,5119764,8135554,30208443,22578498,39208129,1.01091025481,0.906616714404,1.23674962811
2020-07-13,389,136114,,,,,,,445166,349788,556210,6555754,5158439,8186869,30653609,22928286,39764339,1.00449963634,0.903651464758,1.22465338838
2020-07-14,928,137042,,,,,,,443460,347674,554772,6591120,5186753,8227141,31097069,23275960,40319111,0.998596370921,0.89716422742,1.20730044425
2020-07-15,968,138010,,,,,,,441385,345482,553214,6616878,5206377,8257119,31538454,23621442,40872325,0.99318119041,0.895483003685,1.19256929325
2020-07-16,953,138963,,,,,,,438973,342885,550669,6633529,5217172,8277319,31977427,23964327,41422994,0.988231034032,0.89363537572,1.18036405915
2020-07-17,920,139883,,,,,,,436254,339569,548221,6641610,5219725,8289106,32413681,24303896,41971215,0.983725896223,0.891859291314,1.16812643823
2020-07-18,870,140753,,,,,,,433255,336285,545506,6641671,5215096,8293123,32846936,24640181,42516721,0.979648733874,0.891326534254,1.15037351298
2020-07-19,445,141198,,,,,,,430004,333239,542757,6634271,5204105,8289874,33276940,24973420,43059478,0.975981194655,0.890821815129,1.13338300421
2020-07-20,514,141712,,,,,,,426523,329473,540210,6619958,5186628,8280652,33703463,25302893,43599688,0.972700183511,0.887389393918,1.11863283748
2020-07-21,1109,142821,,,,,,,422835,325316,537805,6599268,5162779,8266722,34126298,25628209,44137493,0.969777421575,0.883704233264,1.09690582916
2020-07-22,1211,144032,,,,,,,418961,321046,534950,6572716,5132854,8247528,34545259,25949255,44672443,0.967180938846,0.880281188937,1.07056925905
2020-07-23,1121,145153,,,,,,,414920,316785,532227,6540793,5097376,8224280,34960179,26266040,45204670,0.964876897873,0.879070603554,1.05674202033
2020-07-24,1123,146276,,,,,,,410730,312519,528715,6503965,5056939,8196444,35370909,26578559,45733385,0.962831179874,0.87858017432,1.0501148635
2020-07-25,901,147177,,,,,,,406410,307827,525048,6462670,5011899,8164502,35777319,26886386,46258433,0.961010844277,0.877893284541,1.04451030512
2020-07-26,477,147654,,,,,,,401975,303473,521190,6417318,4963085,8128188,36179294,27189859,46779623,0.959385502121,0.877101480733,1.04006737883
2020-07-27,1125,148779,,,,,,,397441,298974,517098,6368292,4910758,8087880,36576735,27488833,47296721,0.957928386539,0.875897025857,1.03766812049
2020-07-28,1368,150147,,,,,,,392823,294329,513242,6315949,4855268,8044940,36969558,27783162,47809963,0.956616851022,0.875494337048,1.03373880728
2020-07-29,1436,151583,,,,,,,388134,289290,509412,6260624,4796856,7999629,37357692,28072452,48319375,0.955432186597,0.875110892351,1.03031944963
2020-07-30,1216,152799,,,,,,,383387,284557,505009,6202625,4735902,7951476,37741079,28357009,48824384,0.954358888501,0.874743769029,1.02823671301
2020-07-31,1246,154045,,,,,,,378592,279402,500419,6142244,4672381,7901274,38119671,28636411,49324803,0.95338368473,0.874396535718,1.02708699621
2020-08-01,1111,155156,,,,,,,373760,274393,496270,6079750,4607176,7849375,38493431,28910804,49821073,0.952494669113,0.874056049777,1.02572264592
2020-08-02,406,155562,,,,,,,368899,269496,491695,6015394,4540369,7795611,38862330,29180300,50312768,0.951680758248,0.873726859494,1.02488222326
2020-08-03,539,156101,,,,,,,364020,264683,486765,5949411,4471804,7739657,39226350,29444983,50799533,0.950931506007,0.87339757641,1.02349141021
2020-08-04,1378,157479,,,,,,,359130,259992,481959,5882017,4402312,7681412,39585480,29704975,51281492,0.950237169922,0.873088506636,1.0230294193
2020-08-05,1372,158851,,,,,,,354235,255074,477080,5813417,4332063,7620689,39939715,29960049,51758572,0.949588879691,0.872834662802,1.02256696878
2020-08-06,1250,160101,,,,,,,349343,250120,472193,5743799,4261130,7557934,40289058,30210169,52230765,0.948978789371,0.87248890528,1.0221036576
2020-08-07,1243,161344,,,,,,,344460,245287,467982,5673339,4189628,7493685,40633518,30455456,52698747,0.94840015371,0.872156091233,1.02138514685
2020-08-08,1076,162420,,,,,,,339591,240515,463018,5602200,4117628,7427978,40973109,30695971,53161765,0.947847319007,0.871834977168,1.02067849359
2020-08-09,515,162935,,,,,,,334742,236234,458737,5530532,4046035,7361664,41307851,30932205,53620502,0.947315646791,0.871524577268,1.02022728551
2020-08-10,525,163460,,,,,,,329917,231708,453953,5458474,3974267,7294422,41637768,31163913,54074455,0.946801397184,0.871119698656,1.01977411096
2020-08-11,1064,164524,,,,,,,325120,227010,449241,5386153,3902296,7226562,41962888,31390923,54523696,0.94630159609,0.870698511827,1.01918336534
2020-08-12,1507,166031,,,,,,,320357,222490,444595,5313687,3830445,7157922,42283245,31613413,54968291,0.945813903479,0.870230749469,1.01863745595
2020-08-13,1076,167107,,,,,,,315629,217973,439798,5241182,3759122,7088323,42598874,31831386,55408089,0.945336492946,0.869826993448,1.01793573739
2020-08-14,1342,168449,,,,,,,310941,213471,435058,5168736,3688028,7018386,42909815,32044857,55843147,0.944867947288,0.869455154299,1.0172764132
2020-08-15,1029,169478,,,,,,,306295,208774,430199,5096439,3617393,6948179,43216110,32253631,56273346,0.944407171212,0.8698081942,1.01662636506
2020-08-16,571,170049,,,,,,,301692,204362,425377,5024372,3547353,6877305,43517802,32457993,56698723,0.943953320246,0.869591199303,1.01596116173
2020-08-17,445,170494,,,,,,,297136,200151,420882,4952609,3477998,6806512,43814938,32658144,57119605,0.943505743917,0.868521258912,1.01528429844
2020-08-18,1324,171818,,,,,,,292628,195887,416311,4881216,3409191,6736076,44107566,32854031,57535916,0.943063940986,0.868213661154,1.01461789463
2020-08-19,1356,173174,,,,,,,288168,191739,411895,4810255,3340926,6666022,44395734,33045770,57947811,0.94262752452,0.867914921639,1.01395553461
2020-08-20,1078,174252,,,,,,,283760,187665,407491,4739779,3273506,6596437,44679494,33233435,58355302,0.942196194859,0.867624720044,1.01329100006
2020-08-21,1112,175364,,,,,,,279402,183691,403146,4669838,3207068,6527393,44958896,33417126,58758448,0.941769718819,0.867342767002,1.01264446605
2020-08-22,983,176347,,,,,,,275097,179866,398895,4600475,3141641,6458310,45233993,33596992,59157343,0.941347913742,0.867068797578,1.0119398567
2020-08-23,450,176797,,,,,,,270844,176052,394724,4531728,3077179,6390020,45504837,33773044,59552067,0.940930635325,0.866802566318,1.01130365929
2020-08-24,445,177242,,,,,,,266918,172337,390739,4463904,3013283,6322022,45771755,33945381,59942806,0.941408814646,0.869582133379,1.01096617143
2020-08-25,1241,178483,,,,,,,263038,168796,386761,4397026,2950372,6254824,46034793,34114177,60329567,0.941893979242,0.871605082758,1.01076389943
2020-08-26,1222,179705,,,,,,,259218,165420,382938,4331123,2888784,6188510,46294011,34279597,60712505,0.942385676165,0.872826779653,1.01112370147
2020-08-27,1116,180821,,,,,,,255469,162023,379327,4266236,2828316,6123231,46549480,34441620,61091832,0.942883858392,0.872809617158,1.01288422229
2020-08-28,,,888,652,1183,181709,181473,182004,251819,158747,375638,4202425,2769088,6059063,46801299,34600367,61467470,0.94338846955,0.872607889976,1.0137383927
2020-08-29,,,877,640,1172,182586,182114,183176,248293,155690,372006,4139777,2711306,5996011,47049592,34756057,61839476,0.943899441068,0.873006832776,1.01607039674
2020-08-30,,,866,629,1163,183452,182743,184338,244870,152631,368507,4078353,2655161,5934320,47294462,34908688,62207983,0.944416669853,0.872070698037,1.01819007306
2020-08-31,,,855,618,1152,184307,183362,185489,241533,149672,365190,4018194,2600474,5874140,47535995,35058360,62573173,0.94494001437,0.871667342295,1.02048858102
2020-09-01,,,844,607,1142,185151,183969,186630,238281,146693,361966,3959338,2547018,5815233,47774276,35205053,62935139,0.945469366557,0.871539720963,1.02273737513
2020-09-02,,,833,596,1131,185984,184565,187761,235113,143596,358516,3901824,2494729,5757445,48009389,35348649,63293655,0.946004643802,0.87170622405,1.02404382199
2020-09-03,,,822,585,1120,186805,185151,188880,232039,140859,355846,3845695,2443848,5701405,48241428,35489508,63649501,0.946545764265,0.87150599855,1.02566464651
2020-09-04,,,810,573,1109,187616,185725,189989,229058,138153,352839,3790993,2394334,5646761,48470486,35627661,64002340,0.947092644704,0.871970971649,1.02876420277
2020-09-05,,,799,562,1099,188415,186288,191087,226165,135481,349744,3737756,2346122,5593365,48696651,35763142,64352084,0.947645186773,0.870288156214,1.03011606909
2020-09-06,,,788,552,1089,189202,186840,192176,223356,132853,346853,3686015,2299108,5541333,48920007,35895995,64698937,0.948203292112,0.869996015427,1.03225346417
2020-09-07,,,777,541,1078,189979,187382,193254,220630,130304,344865,3635801,2253359,5491482,49140637,36026299,65043802,0.948766867782,0.869067145805,1.03409596282
2020-09-08,,,765,531,1067,190745,187913,194321,217989,127768,342949,3586871,2208789,5443692,49358626,36154067,65386751,0.949335823778,0.868481947524,1.0353675861
2020-09-09,,,754,521,1057,191499,188435,195377,215432,125432,341432,3539265,2165424,5398358,49574058,36279499,65728183,0.949910069627,0.869036210514,1.03726303038
2020-09-10,,,743,510,1046,192242,188946,196423,212959,123088,339783,3493006,2123091,5355194,49787017,36402587,66067966,0.950489510561,0.868390416672,1.04032654454
2020-09-11,,,732,500,1035,192975,189446,197457,210568,120687,338670,3448104,2081756,5314526,49997585,36523274,66406636,0.951074048694,0.867201812684,1.04404136061
2020-09-12,,,722,490,1024,193696,189937,198480,208258,118336,336442,3404543,2041346,5275318,50205843,36641610,66743078,0.951663585389,0.864968232065,1.04690403138
2020-09-13,,,711,479,1013,194407,190417,199492,206028,116162,335307,3362278,2001819,5238601,50411871,36757772,67078385,0.952258021565,0.863169756587,1.04915768353
2020-09-14,,,700,469,1002,195107,190886,200493,203880,114044,333272,3321288,1963235,5203355,50615751,36871816,67411657,0.95285725704,0.863542434138,1.05180802599
2020-09-15,,,690,459,992,195797,191346,201484,201812,112213,332123,3281566,1925779,5170286,50817563,36984029,67743780,0.953461189231,0.862017706024,1.05460481645
2020-09-16,,,679,449,981,196476,191796,202464,199823,110250,330581,3243108,1889339,5138899,51017386,37094279,68074361,0.954069712756,0.861018636346,1.05698192139
2020-09-17,,,669,440,970,197146,192237,203434,197914,108479,329132,3205909,1854222,5109513,51215300,37202758,68403493,0.954682719804,0.860618566888,1.0602453741
2020-09-18,,,659,431,960,197805,192669,204393,196084,106631,327938,3169954,1819993,5081602,51411384,37309389,68731431,0.955300100367,0.86023690648,1.06292127072
2020-09-19,,,649,422,951,198454,193091,205344,194333,104728,327209,3135229,1786566,5055970,51605717,37414117,69058640,0.955921742137,0.85836088885,1.06458486157
2020-09-20,,,640,414,941,199094,193505,206285,192661,102844,326574,3101725,1753925,5032786,51798378,37516961,69385214,0.956547530082,0.857340852785,1.06727957586
2020-09-21,,,630,405,932,199725,193911,207216,191067,101055,326481,3069436,1722125,5012402,51989445,37618016,69711695,0.957177346088,0.855937561998,1.07052869539
2020-09-22,,,621,397,923,200346,194309,208138,189553,99361,326724,3038359,1691180,4994254,52178998,37717377,70038419,0.957811068816,0.854539497999,1.07391765357
2020-09-23,,,612,388,914,200958,194698,209051,188117,97703,326872,3008488,1661113,4978170,52367115,37815080,70365291,0.958448573648,0.852944706476,1.07673966381
2020-09-24,,,603,380,904,201562,195079,209954,186760,96066,327171,2979816,1631744,4963901,52553875,37911146,70692462,0.959089732565,0.851850788039,1.07899103803
2020-09-25,,,595,373,894,202157,195452,210847,185482,94480,327813,2952340,1603134,4951923,52739357,38005626,71020275,0.959734413919,0.850248281817,1.08181530964
2020-09-26,,,587,366,887,202743,195818,211733,184284,92848,328510,2926057,1575293,4941756,52923641,38098474,71348785,0.960382482162,0.848653492985,1.08490205435
2020-09-27,,,578,359,879,203322,196178,212611,183165,91139,329214,2900964,1548095,4934520,53106806,38189613,71677999,0.961033797602,0.846631996694,1.08809336941
2020-09-28,,,570,351,870,203892,196530,213480,182127,89687,330624,2877063,1521620,4929837,53288933,38279300,72008623,0.961688216199,0.844717401762,1.09141279932
2020-09-29,,,563,344,862,204455,196875,214340,181169,88196,332300,2854352,1495773,4928876,53470102,38367496,72340923,0.962345589353,0.842811148718,1.09490603335
2020-09-30,,,555,338,854,205010,197213,215193,180293,86812,334361,2832833,1470374,4931125,53650395,38454308,72675284,0.963005763653,0.841126561415,1.09877867095
2020-10-01,,,548,331,847,205558,197545,216039,179498,85337,336838,2812508,1445463,4937395,53829893,38539645,73012122,0.963673626019,0.840002980036,1.10151444998
2020-10-02,,,541,324,841,206098,197870,216878,178786,83917,339921,2793380,1420903,4948194,54008679,38623562,73352043,0.964346915929,0.838278159545,1.10500271189
2020-10-03,,,534,318,833,206632,198189,217710,178158,82639,342825,2775455,1396912,4963086,54186837,38706201,73694868,0.965023367456,0.836503583611,1.10803734085
2020-10-04,,,527,312,827,207160,198501,218536,177615,81375,345766,2758737,1373558,4981649,54364452,38787576,74040634,0.965704732672,0.834735997075,1.11106566185
2020-10-05,,,521,305,822,207680,198807,219356,177157,80283,350043,2743233,1350997,5005119,54541609,38867859,74390677,0.966395038423,0.832975294482,1.11408685529
2020-10-06,,,514,300,817,208195,199108,220172,176786,79003,354841,2728951,1328944,5033477,54718395,38946862,74745518,0.967089237334,0.831221371198,1.11711253928
2020-10-07,,,508,294,813,208703,199403,220984,176502,77760,358944,2715900,1307342,5065703,54894897,39024622,75104462,0.967784940344,0.829575179042,1.12021026236
2020-10-08,,,502,289,810,209205,199692,221792,176308,76592,362954,2704091,1286230,5101790,55071205,39101214,75467416,0.968482467921,0.827826361416,1.12335763029
2020-10-09,,,497,283,805,209702,199976,222596,176204,75406,367061,2693535,1265572,5141689,55247409,39176620,75834477,0.969185572923,0.826095810945,1.12891300272
2020-10-10,,,491,278,802,210193,200255,223396,176192,74278,373503,2684245,1245373,5187385,55423601,39250898,76207980,0.969898523459,0.825372159126,1.13243719831
2020-10-11,,,486,273,797,210679,200528,224191,176274,73239,378363,2676235,1225765,5237238,55599875,39324137,76586343,0.970615424738,0.824019522605,1.13584706277
2020-10-12,,,481,267,793,211160,200797,224982,176451,72182,383815,2669521,1206810,5291836,55776326,39396319,76970158,0.971333951294,0.823717613361,1.1394641195
2020-10-13,,,476,263,790,211636,201060,225771,176726,71100,389811,2664119,1188226,5351023,55953052,39467419,77359969,0.972060332036,0.823389305793,1.14263502604
2020-10-14,,,471,259,786,212108,201320,226555,177099,70152,395733,2660049,1170183,5414458,56130151,39537571,77755702,0.972791847746,0.823063784624,1.14578098728
2020-10-15,,,467,255,783,212574,201575,227337,177573,69272,401755,2657330,1152646,5481848,56307724,39606843,78157457,0.97353853497,0.822378743827,1.14890002643
2020-10-16,,,462,250,781,213037,201826,228116,178151,68341,407460,2655983,1135653,5552462,56485875,39675184,78564917,0.974289576897,0.821526818714,1.15133978854
2020-10-17,,,458,246,779,213495,202073,228894,178835,67448,414487,2656031,1119187,5627010,56664710,39742632,78979404,0.975040626815,0.820441287599,1.15535789039
2020-10-18,,,454,241,779,213950,202315,229670,179626,66648,420868,2657499,1103195,5705023,56844336,39809280,79400272,0.975791597266,0.819654611714,1.15925268474
2020-10-19,,,451,237,778,214400,202553,230446,180528,65744,427723,2660412,1087563,5786947,57024864,39875024,79827995,0.976546201367,0.819389716828,1.1630907251
2020-10-20,,,447,233,779,214847,202787,231224,181543,64898,436241,2664798,1072175,5873109,57206407,39939922,80264236,0.977307062925,0.819216095885,1.16610612574
2020-10-21,,,444,229,780,215291,203017,232001,182675,64108,445906,2670688,1057279,5964126,57389082,40004030,80710142,0.978069994666,0.81927366654,1.16917332889
2020-10-22,,,441,225,781,215732,203243,232780,183926,63361,456835,2678112,1042878,6061996,57573008,40067391,81166977,0.978844918352,0.818621921983,1.17202528903
2020-10-23,,,438,221,781,216169,203466,233559,185299,62622,467940,2687104,1028905,6166962,57758307,40130013,81634917,0.979619868393,0.81754780566,1.17568738288
2020-10-24,,,435,218,783,216604,203684,234339,186798,61902,479685,2697698,1015399,6279560,57945105,40191915,82114602,0.980394673081,0.81800939704,1.1787371291
2020-10-25,,,432,214,785,217036,203899,235122,188427,61055,491265,2709932,1002174,6397309,58133532,40252970,82605867,0.981168309198,0.817053817261,1.18194824294
2020-10-26,,,430,210,789,217466,204111,235908,190188,60351,504205,2723846,989283,6523149,58323720,40313321,83110072,0.981943521808,0.817067783982,1.1847783631
2020-10-27,,,428,207,794,217894,204319,236699,192085,59889,518779,2739479,976987,6658114,58515805,40373210,83628851,0.982714167103,0.816593561337,1.18839923712
2020-10-28,,,426,203,799,218319,204523,237496,194123,59408,532331,2756877,965295,6800632,58709928,40432618,84161182,0.983480890395,0.816001226852,1.19137719742
2020-10-29,,,424,200,806,218743,204724,238299,196305,58866,546218,2776083,954010,6951119,58906233,40491484,84707400,0.9842468132,0.815367405101,1.19462071315
2020-10-30,,,422,197,812,219165,204923,239108,198636,58314,557391,2797146,943056,7106785,59104869,40549798,85264791,0.985015544591,0.815091471594,1.19782515763
2020-10-31,,,421,194,819,219586,205118,239924,201120,57698,571718,2820115,932417,7271063,59305989,40607496,85836509,0.98577792302,0.814443720088,1.20098746415
2020-11-01,,,420,191,828,220005,205310,240749,203762,57240,587348,2845042,922212,7443938,59509751,40664736,86423857,0.986534430284,0.8133821148,1.20434655516
