date,actual_deaths,total_deaths,predicted_deaths_mean,predicted_deaths_lower,predicted_deaths_upper,predicted_total_deaths_mean,predicted_total_deaths_lower,predicted_total_deaths_upper,predicted_new_infected_mean,predicted_new_infected_lower,predicted_new_infected_upper,predicted_current_infected_mean,predicted_current_infected_lower,predicted_current_infected_upper,predicted_total_infected_mean,predicted_total_infected_lower,predicted_total_infected_upper,r_values_mean,r_values_lower,r_values_upper
2020-02-05,0,0,,,,,,,126,66,178,126,66,178,126,66,178,2.26217785361,2.1,2.4
2020-02-06,0,0,,,,,,,126,66,178,251,132,356,252,132,356,2.26216851654,2.09998862618,2.39999969889
2020-02-07,0,0,,,,,,,126,66,178,377,197,534,378,198,534,2.26216536279,2.09998467792,2.39999953805
2020-02-08,0,0,,,,,,,126,66,178,503,264,712,504,264,712,2.26216113133,2.09997936768,2.39999929126
2020-02-09,0,0,,,,,,,286,162,405,789,441,1102,790,426,1117,2.26215544891,2.09997224556,2.39999891271
2020-02-10,0,0,,,,,,,286,162,405,1074,608,1501,1076,588,1522,2.26214781108,2.09996266269,2.39999833733
2020-02-11,0,0,,,,,,,286,162,405,1360,774,1903,1362,750,1927,2.26213753521,2.09994976818,2.39999751086
2020-02-12,0,0,,,,,,,286,162,405,1646,939,2305,1648,912,2332,2.26212369646,2.09993241661,2.39999627467
2020-02-13,0,0,,,,,,,459,277,648,2105,1233,2931,2107,1189,2980,2.26210504025,2.09990906619,2.39999442455
2020-02-14,0,0,,,,,,,669,406,934,2774,1644,3858,2776,1595,3914,2.2620504954,2.09985010174,2.39996772909
2020-02-15,0,0,,,,,,,1208,744,1624,3982,2442,5443,3984,2339,5538,2.26201280825,2.09980617554,2.3999605875
2020-02-16,0,0,,,,,,,2405,1462,3091,6388,4031,8471,6389,3801,8629,2.26195482694,2.09973974022,2.3999441386
2020-02-17,0,0,,,,,,,3892,2516,4921,10280,6680,13304,10281,6317,13550,2.26188058657,2.09965532049,2.39992486234
2020-02-18,0,0,,,,,,,4309,2826,5458,14589,9546,18734,14590,9143,19008,2.2617832681,2.0995441264,2.39990116943
2020-02-19,0,0,,,,,,,5060,3375,6403,19648,12981,25090,19650,12518,25411,2.26165389539,2.0994051107,2.39986975205
2020-02-20,0,0,,,,,,,5201,3478,6594,24724,16404,31497,24851,15996,32005,2.26147947832,2.09921831274,2.39982560829
2020-02-21,0,0,,,,,,,5733,3899,7259,30331,20260,38557,30584,19895,39264,2.26124273204,2.09897715061,2.39976199992
2020-02-22,0,0,,,,,,,6789,4697,8625,36994,24937,46965,37373,24592,47889,2.2609239567,2.09867517858,2.39967346016
2020-02-23,0,0,,,,,,,8126,5720,10304,44994,30682,57015,45499,30312,58193,2.26049476454,2.09828522154,2.39954788462
2020-02-24,0,0,,,,,,,10341,7274,13191,55049,37873,69744,55840,37586,71384,2.25991450044,2.09776761864,2.3993669437
2020-02-25,0,0,,,,,,,16237,10841,20662,71000,48728,89883,72077,48427,92046,2.25912728696,2.09705367714,2.39910473292
2020-02-26,0,0,,,,,,,19627,13333,25049,90341,61942,114490,91704,61760,117095,2.25805619263,2.09611114151,2.39872592446
2020-02-27,0,0,,,,,,,21399,14421,27530,111453,76214,141600,113103,76181,144625,2.2565971089,2.09485310061,2.39818809029
2020-02-28,0,0,,,,,,,25998,17360,33780,136992,93294,174728,139101,93541,178405,2.25460690335,2.09318650039,2.39738332981
2020-02-29,1,1,,,,,,,31820,20675,41994,168143,113572,215747,170921,114216,220399,2.25188825381,2.09097911354,2.39619112718
2020-03-01,0,1,,,,,,,41358,26294,55250,208293,139184,269256,212279,140510,275649,2.24817043967,2.08805669853,2.39444024972
2020-03-02,5,6,,,,,,,51441,32380,69355,257328,170206,335368,263720,172890,345004,2.24308411751,2.08401953844,2.39183699396
2020-03-03,1,7,,,,,,,63831,39997,86748,317267,207782,417052,327551,212887,431752,2.23612939208,2.07843705736,2.38796364909
2020-03-04,4,11,,,,,,,78380,48463,107563,391339,253524,518991,405931,261350,539315,2.22663598017,2.07112151805,2.38220770558
2020-03-05,1,12,,,,,,,98041,59955,135729,484320,310209,648119,503972,321305,675044,2.21371817882,2.06069801156,2.37365554963
2020-03-06,2,14,,,,,,,120188,72755,167749,599307,379593,809048,624160,394060,842793,2.19623202712,2.04699537009,2.36113240872
2020-03-07,3,17,,,,,,,145234,88066,203591,738808,463844,1005212,769394,482126,1046384,2.1727493738,2.02757841627,2.34394480486
2020-03-08,4,21,,,,,,,172610,106005,240422,904629,565144,1236929,942004,588131,1286806,2.14157609336,1.99216287077,2.32111157233
2020-03-09,1,22,,,,,,,201565,127175,276329,1098068,686475,1502999,1143569,715306,1563135,2.10085530137,1.93765908012,2.28655625472
2020-03-10,6,28,,,,,,,231013,152160,312260,1318740,831113,1802211,1374582,867466,1875395,2.04880225532,1.86751272311,2.26207636915
2020-03-11,5,33,,,,,,,257211,174319,344080,1559714,994555,2125570,1631793,1041785,2219475,1.98409360877,1.78302046414,2.23943610798
2020-03-12,10,43,,,,,,,278591,189281,371592,1818678,1170376,2472117,1910384,1231066,2591067,1.90635901017,1.6856717078,2.18490535
2020-03-13,8,51,,,,,,,294992,203542,391199,2092272,1359389,2835736,2205376,1434608,2982266,1.81661539185,1.57123495766,2.11673833872
2020-03-14,7,58,,,,,,,306229,211052,402171,2372503,1553009,3204037,2511605,1645660,3384437,1.71742847231,1.45667776521,2.04762278204
2020-03-15,12,70,,,,,,,313656,217121,412671,2654339,1749524,3574536,2825261,1862781,3797108,1.61267140652,1.34077468739,1.97883795399
2020-03-16,27,97,,,,,,,317738,222168,423155,2930719,1945615,3942199,3142999,2084949,4220263,1.50693945258,1.21876849932,1.89300020278
2020-03-17,35,132,,,,,,,319370,226428,427985,3198648,2140038,4300543,3462369,2311377,4648248,1.40482448238,1.12800305303,1.78638824434
2020-03-18,59,191,,,,,,,319412,230504,428554,3454229,2331176,4641996,3781781,2541881,5076802,1.31026742586,1.05775713444,1.67052724621
2020-03-19,73,264,,,,,,,318384,233173,425549,3694233,2516755,4959465,4100165,2775054,5502351,1.2261236255,1.00548651841,1.54605590918
2020-03-20,99,363,,,,,,,316754,235409,423643,3912946,2693368,5246680,4416919,3010463,5925994,1.15397732406,0.969504863981,1.44597441726
2020-03-21,99,462,,,,,,,314628,236743,419940,4107385,2858704,5498128,4731547,3247206,6345934,1.09418268104,0.940770996891,1.34452753008
2020-03-22,110,572,,,,,,,312097,237611,416458,4274249,3009783,5710301,5043644,3484817,6762392,1.04608501209,0.92321939316,1.2632867705
2020-03-23,189,761,,,,,,,309289,238033,410953,4410927,3143440,5880146,5352933,3722850,7173345,1.00835369739,0.908320631678,1.191382086
2020-03-24,239,1000,,,,,,,306236,237580,403402,4515599,3255494,6006426,5659169,3960430,7576747,0.979335328248,0.890253423724,1.12831671453
2020-03-25,324,1324,,,,,,,302967,234598,396162,4587553,3339199,6089336,5962136,4195028,7972909,0.957343199392,0.876647841339,1.07321479465
2020-03-26,408,1732,,,,,,,299466,232959,389549,4629808,3399001,6133879,6261602,4427987,8362458,0.940842332915,0.86598868708,1.03718294771
2020-03-27,518,2250,,,,,,,295711,231157,382900,4646928,3441568,6144313,6557313,4659144,8745358,0.928535559673,0.85799659977,1.00658944181
2020-03-28,633,2883,,,,,,,291702,227664,376073,4643638,3465778,6128356,6849015,4886808,9121431,0.919380074969,0.852697108121,0.986562970052
2020-03-29,586,3469,,,,,,,287471,223721,369250,4624879,3477856,6094760,7136486,5110529,9490681,0.912565662876,0.846753292379,0.972352332957
2020-03-30,692,4161,,,,,,,282963,219656,362062,4594186,3479218,6043785,7419449,5330185,9852743,0.90747734137,0.844412095743,0.962596324062
2020-03-31,1085,5246,,,,,,,278227,214989,354571,4554675,3470395,5975337,7697676,5545174,10207314,0.903655689868,0.842585615632,0.957071884598
2020-04-01,1172,6418,,,,,,,273281,210521,347346,4508586,3452683,5895301,7970957,5755695,10554660,0.900761168822,0.840973406004,0.952659111405
2020-04-02,1503,7921,,,,,,,268152,206085,340114,4457326,3426587,5807790,8239109,5961780,10894774,0.898544616186,0.839714345031,0.94931079999
2020-04-03,1392,9313,,,,,,,262867,201919,333637,4401809,3393790,5716886,8501976,6163699,11228411,0.896824017214,0.838578534896,0.946624806954
2020-04-04,1523,10836,,,,,,,257456,197384,326745,4342511,3354439,5621071,8759432,6361083,11555156,0.895466764751,0.83776982935,0.94482846058
2020-04-05,1590,12426,,,,,,,251953,192804,319953,4279837,3309443,5522264,9011385,6553887,11875109,0.894376377905,0.83708882375,0.943283243257
2020-04-06,1770,14196,,,,,,,246397,188334,313350,4214137,3259449,5420458,9257782,6742221,12188459,0.893482686785,0.836519272177,0.942150170666
2020-04-07,2571,16767,,,,,,,240824,183914,306432,4145673,3204885,5317172,9498606,6926135,12494891,0.89273463993,0.835868206791,0.941103135199
2020-04-08,2146,18913,,,,,,,235270,179563,299514,4074707,3146597,5214275,9733876,7105698,12794405,0.892095062161,0.835364008393,0.940476204025
2020-04-09,2228,21141,,,,,,,229766,175147,292535,4001506,3086907,5111373,9963642,7280845,13086940,0.891536846797,0.834881287441,0.939820995705
2020-04-10,2218,23359,,,,,,,224336,170731,285467,3926376,3024535,5007860,10187978,7451576,13372407,0.891040195118,0.834410876073,0.939334083439
2020-04-11,2119,25478,,,,,,,219002,166546,278929,3849667,2959815,4904303,10406980,7618122,13651336,0.890587503968,0.834020379178,0.938861543942
2020-04-12,1816,27294,,,,,,,213777,162344,272606,3771743,2894410,4801104,10620757,7780466,13923942,0.890172994344,0.833560629545,0.938432425434
2020-04-13,1946,29240,,,,,,,208672,158217,266346,3692944,2828835,4698384,10829429,7938683,14190288,0.889786340125,0.833260232065,0.938108577877
2020-04-14,2455,31695,,,,,,,203691,154204,260315,3613673,2763346,4596723,11033120,8092887,14450603,0.889423978964,0.832921399363,0.937805335555
2020-04-15,2609,34304,,,,,,,198838,150366,254759,3534284,2698714,4496943,11231958,8243253,14705362,0.889090252173,0.832586894624,0.937516781341
2020-04-16,2176,36480,,,,,,,194111,146366,249152,3455114,2634570,4398763,11426069,8389619,14954514,0.888769642771,0.83230952569,0.937236593844
2020-04-17,2093,38573,,,,,,,189510,142694,243875,3376473,2571203,4302534,11615579,8532313,15198389,0.888465149741,0.832060002506,0.936960344732
2020-04-18,1960,40533,,,,,,,185031,139007,238807,3298637,2508319,4207717,11800610,8671320,15437196,0.888175305461,0.831811192142,0.936687845716
2020-04-19,1931,42464,,,,,,,180671,135408,233929,3221852,2446369,4114927,11981281,8806728,15671125,0.887901088353,0.831516335633,0.936418962166
2020-04-20,2186,44650,,,,,,,176427,131828,228995,3146326,2385412,4024004,12157708,8938556,15900120,0.887642550801,0.83128813455,0.93613008755
2020-04-21,2548,47198,,,,,,,172294,128196,224383,3072222,2325279,3935091,12330002,9066752,16124503,0.887400009582,0.831074937068,0.935874765597
2020-04-22,2434,49632,,,,,,,168270,124792,219873,2999668,2266154,3848612,12498272,9191544,16344376,0.887174650984,0.830864282131,0.935616705012
2020-04-23,2466,52098,,,,,,,164351,121468,215471,2928748,2208039,3764671,12662623,9313012,16559847,0.886970052738,0.830645557466,0.935363455458
2020-04-24,2154,54252,,,,,,,160536,118182,211105,2859518,2151030,3683348,12823159,9431194,16770952,0.886790617373,0.830438034932,0.9351282482
2020-04-25,1698,55950,,,,,,,156824,114906,206865,2792006,2095162,3604857,12979983,9546100,16977817,0.886642392829,0.830258866089,0.935008603266
2020-04-26,1329,57279,,,,,,,153212,111796,202935,2726216,2040372,3528961,13133195,9657896,17180752,0.886534224219,0.830096084041,0.934801270513
2020-04-27,1466,58745,,,,,,,149699,108626,199106,2662137,1986612,3455548,13282894,9766522,17379858,0.886477216945,0.829918440447,0.934604257223
2020-04-28,2241,60986,,,,,,,146283,105588,195336,2599748,1933943,3384608,13429177,9872110,17575194,0.8864867317,0.829958048236,0.934460631117
2020-04-29,2521,63507,,,,,,,142965,102674,191686,2539021,1882373,3316031,13572142,9974784,17766880,0.886583190865,0.829876765927,0.934315173311
2020-04-30,2322,65829,,,,,,,139744,99862,188084,2479927,1831832,3249394,13711886,10074646,17954964,0.886793504649,0.829895419359,0.934310057316
2020-05-01,1891,67720,,,,,,,136622,97125,184777,2422438,1782563,3185042,13848508,10171771,18139741,0.887152741698,0.82994499532,0.934308535728
2020-05-02,1692,69412,,,,,,,133598,94374,181312,2366525,1734220,3122490,13982106,10266145,18321053,0.887706083486,0.829929820907,0.934588125103
2020-05-03,1120,70532,,,,,,,130673,91801,178067,2312167,1686994,3061753,14112779,10357946,18499120,0.88851045112,0.829847560384,0.934810583962
2020-05-04,1333,71865,,,,,,,127851,89347,174916,2259347,1640916,3002736,14240630,10447293,18674036,0.889635638335,0.830096753975,0.935607079488
2020-05-05,2318,74183,,,,,,,125135,86990,171978,2208054,1596061,2945710,14365765,10534283,18846014,0.89116390283,0.830323061132,0.937295321224
2020-05-06,2364,76547,,,,,,,122528,84674,169115,2158289,1552525,2890430,14488293,10618957,19015129,0.893186888682,0.830510176064,0.944898788964
2020-05-07,1934,78481,,,,,,,120035,82480,166396,2110054,1510198,2836941,14608328,10701437,19181525,0.895798639683,0.831021188839,0.95460447875
2020-05-08,1747,80228,,,,,,,117662,80339,163733,2063366,1469053,2785190,14725990,10781776,19345258,0.899084306778,0.83152884565,0.970594559012
2020-05-09,1488,81716,,,,,,,115417,78348,161291,2018247,1429205,2735364,14841407,10860124,19506549,0.903106443947,0.831935587045,0.992878694334
2020-05-10,893,82609,,,,,,,113308,76460,159040,1974731,1390748,2687527,14954715,10936584,19665589,0.907894188218,0.83238595301,1.01962538043
2020-05-11,1014,83623,,,,,,,111347,74789,156963,1932866,1353733,2641542,15066062,11011373,19822552,0.913442537871,0.832552275818,1.05069796951
2020-05-12,1627,85250,,,,,,,109545,73200,155098,1892713,1318300,2597520,15175607,11084573,19977650,0.919725361706,0.833623827574,1.07876449764
2020-05-13,1764,87014,,,,,,,107916,71763,153533,1854346,1284474,2555703,15283523,11156336,20131183,0.926716451711,0.834670864631,1.10444241954
2020-05-14,1783,88797,,,,,,,106473,70486,152101,1817854,1252287,2516102,15389996,11226822,20283284,0.934405725999,0.836065643293,1.13055566371
2020-05-15,1681,90478,,,,,,,105231,69349,150785,1783342,1221776,2478785,15495227,11296171,20434069,0.942801643501,0.838165539407,1.15363824743
2020-05-16,1216,91694,,,,,,,104204,68387,149785,1750924,1193045,2443773,15599431,11364558,20583854,0.951922909717,0.841341420585,1.17325317528
2020-05-17,758,92452,,,,,,,103406,67520,149072,1720732,1166202,2411511,15702837,11432078,20732926,0.961788385666,0.845471817991,1.18696829612
2020-05-18,1172,93624,,,,,,,102849,66891,148547,1692908,1141304,2381967,15805686,11498969,20881473,0.972406786823,0.850800559449,1.20029330971
2020-05-19,1552,95176,,,,,,,102547,66454,148363,1667604,1118427,2355391,15908233,11565423,21029836,0.983758473366,0.857806617192,1.23329386651
2020-05-20,1526,96702,,,,,,,102511,66258,148552,1644980,1097722,2331940,16010744,11631681,21178388,0.995766959937,0.866495457307,1.24468972555
2020-05-21,1217,97919,,,,,,,102752,66257,149302,1625204,1079340,2312092,16113496,11697938,21327690,1.00827518257,0.87471767507,1.25354751374
2020-05-22,1244,99163,,,,,,,103281,66455,150101,1608449,1063354,2295762,16216777,11764393,21477791,1.0210502763,0.875531004219,1.25888188136
2020-05-23,1109,100272,,,,,,,104108,66920,151351,1594895,1049978,2283343,16320885,11831313,21629142,1.03382615774,0.875673268394,1.26071971037
2020-05-24,622,100894,,,,,,,105244,67557,152962,1584722,1039237,2274975,16426129,11898870,21782104,1.04636612068,0.875977654217,1.26408138262
2020-05-25,548,101442,,,,,,,106698,68356,154858,1578112,1031188,2270752,16532827,11967226,21936962,1.05851225832,0.876443433862,1.27820464678
2020-05-26,662,102104,,,,,,,108488,69516,157201,1575253,1025973,2270951,16641315,12036742,22094163,1.07019756038,0.87736578121,1.29622705496
2020-05-27,1518,103622,,,,,,,110626,71045,159965,1576334,1023875,2275781,16751941,12107787,22254128,1.08142192917,0.878826475953,1.30873921835
2020-05-28,1178,104800,,,,,,,113115,72848,163139,1581533,1025023,2285350,16865056,12180635,22417267,1.09221436367,0.881299758903,1.31413676895
2020-05-29,1160,105960,,,,,,,115968,74932,166746,1591028,1029528,2299957,16981024,12255567,22584013,1.10259750643,0.883405041133,1.32224096275
2020-05-30,963,106923,,,,,,,119198,77232,170690,1604995,1037463,2319821,17100222,12332799,22754703,1.11261883863,0.886639347324,1.33387419559
2020-05-31,581,107504,,,,,,,122821,79775,175112,1623611,1048899,2345105,17223043,12412574,22929815,1.12231363158,0.891628786536,1.34132296893
2020-06-01,776,108280,,,,,,,126855,82762,180378,1647060,1064187,2376360,17349898,12495336,23110193,1.13172299569,0.898162251727,1.34658182604
2020-06-02,1068,109348,,,,,,,131317,86119,185813,1675528,1083445,2413585,17481215,12581455,23296006,1.14083908005,0.907599772366,1.35040083924
2020-06-03,1007,110355,,,,,,,136222,89821,191871,1709203,1106825,2457049,17617437,12671276,23487877,1.14961959331,0.921040906269,1.35338976846
2020-06-04,1023,111378,,,,,,,141591,94025,198956,1748283,1134598,2507390,17759028,12765301,23686833,1.15797310042,0.930452826191,1.35467525436
2020-06-05,914,112292,,,,,,,147438,98227,206637,1792970,1166576,2564640,17906466,12863528,23893470,1.16581464568,0.935487088028,1.35546071203
2020-06-06,659,112951,,,,,,,153783,103027,215058,1843472,1203140,2629500,18060249,12966555,24108528,1.17307320195,0.941152030387,1.353637342
2020-06-07,438,113389,,,,,,,160640,108167,224228,1900003,1244375,2702283,18220889,13074722,24332756,1.17967002052,0.947706870234,1.35128368936
2020-06-08,519,113908,,,,,,,168022,113684,233770,1962781,1290487,2783001,18388911,13188406,24566526,1.18555726759,0.957670886953,1.35368438584
2020-06-09,950,114858,,,,,,,175938,119673,244535,2032021,1341788,2872591,18564849,13308079,24811061,1.19066970186,0.968348183725,1.35368428263
2020-06-10,901,115759,,,,,,,184390,125865,255730,2107922,1398117,2971039,18749239,13433944,25066791,1.19495447842,0.984684541486,1.35383454177
2020-06-11,871,116630,,,,,,,193371,132550,267769,2190668,1459597,3078755,18942610,13566494,25334560,1.1983882671,1.00793621407,1.35394095127
2020-06-12,828,117458,,,,,,,202871,139475,280564,2280423,1526212,3196100,19145481,13705969,25615124,1.20092986938,1.03480971089,1.35221749696
2020-06-13,759,118217,,,,,,,212861,147134,293959,2377316,1598399,3323257,19358342,13853103,25909083,1.20256232271,1.05507512626,1.35045778573
2020-06-14,308,118525,,,,,,,223305,155119,308039,2481423,1676266,3460571,19581647,14008222,26217122,1.2032432003,1.05175236126,1.35218693483
2020-06-15,394,118919,,,,,,,234149,163355,322319,2592752,1759831,3607775,19815796,14171577,26539441,1.20297361807,1.04795357974,1.35127726343
2020-06-16,838,119757,,,,,,,245329,172106,336930,2711226,1849177,3764366,20061125,14343683,26876371,1.20173322425,1.0367385312,1.35135939062
2020-06-17,744,120501,,,,,,,256768,181020,350731,2836677,1944085,3929351,20317893,14524703,27227102,1.19953885075,1.03103490809,1.35041430882
2020-06-18,718,121219,,,,,,,268378,190504,365625,2968833,2044772,4103184,20586271,14715207,27592727,1.19642077757,1.02265022063,1.35091863347
2020-06-19,670,121889,,,,,,,280061,199764,380015,3107303,2150517,4284286,20866332,14914971,27972742,1.19239978213,1.01324939058,1.35066055393
2020-06-20,604,122493,,,,,,,291710,209132,394643,3251575,2261423,4472326,21158042,15124103,28367385,1.18750829951,1.00521620962,1.35295517862
2020-06-21,285,122778,,,,,,,303215,218814,408391,3401007,2377185,4665676,21461257,15342917,28775776,1.18177798146,0.996719839982,1.35315014074
2020-06-22,389,123167,,,,,,,314460,228505,422200,3554827,2497501,4863645,21775717,15571422,29197976,1.17530484395,0.988377427811,1.35318850513
2020-06-23,847,124014,,,,,,,325337,237600,434352,3712142,2621372,5064210,22101054,15809022,29632328,1.16821094209,0.983964635449,1.35298624417
2020-06-24,759,124773,,,,,,,335749,246659,446424,3871954,2748314,5266027,22436803,16055681,30078752,1.16063679205,0.977657432477,1.35283344828
2020-06-25,551,125324,,,,,,,345618,255450,457606,4033182,2877855,5467767,22782421,16311131,30536358,1.15272832815,0.973406053043,1.35297221953
2020-06-26,617,125941,,,,,,,354884,264197,467711,4194695,3009468,5667528,23137305,16575328,31004069,1.14459033581,0.969310365612,1.35170344152
2020-06-27,504,126445,,,,,,,363511,271936,477218,4355335,3141918,5864069,23500816,16847264,31481287,1.13633134262,0.9671273813,1.35156970837
2020-06-28,273,126718,,,,,,,371479,278477,485487,4513953,3273266,6055538,23872295,17125741,31966774,1.1280246044,0.961996808055,1.35041423186
2020-06-29,377,127095,,,,,,,378776,284827,492877,4669424,3403004,6240417,24251071,17410568,32459651,1.11973368912,0.958258140597,1.3491822022
2020-06-30,625,127720,,,,,,,385402,290564,500804,4820677,3530272,6418997,24636473,17701132,32960455,1.11149721456,0.955609605619,1.34810320377
2020-07-01,694,128414,,,,,,,391360,295960,508440,4966708,3654168,6590643,25027833,17997092,33468895,1.1033156729,0.953871649199,1.34508432886
2020-07-02,727,129141,,,,,,,396662,300716,513718,5106602,3773903,6753768,25424495,18297808,33982613,1.0951783089,0.952016581151,1.34057230536
2020-07-03,660,129801,,,,,,,401323,304766,519655,5239547,3888199,6907931,25825818,18602574,34502268,1.08705328557,0.948771259633,1.33454418421
2020-07-04,265,130066,,,,,,,405367,308690,523926,5364854,3997146,7051916,26231185,18911264,35026194,1.0789292996,0.947208434906,1.32592394999
2020-07-05,288,130354,,,,,,,408819,311816,527574,5481963,4099830,7184887,26640004,19223080,35553768,1.07081320485,0.942916984012,1.31421494836
2020-07-06,355,130709,,,,,,,411709,314847,530507,5590456,4195865,7307022,27051713,19537927,36084275,1.06273541247,0.939835863938,1.30236355589
2020-07-07,1222,131931,,,,,,,414062,317575,532855,5690058,4284908,7417671,27465775,19855502,36617130,1.05474346779,0.937470263893,1.29117436974
2020-07-08,863,132794,,,,,,,415903,319474,534470,5780624,4366763,7517763,27881678,20174976,37151600,1.04689849619,0.936301221502,1.28508000211
2020-07-09,1003,133797,,,,,,,417257,321017,535294,5862132,4441105,7606584,28298935,20495993,37686894,1.03926659028,0.934065318506,1.27806682027
2020-07-10,824,134621,,,,,,,418145,321919,536132,5934659,4507559,7685057,28717080,20817912,38223026,1.03191280979,0.932752453595,1.26988211977
2020-07-11,690,135311,,,,,,,418588,322863,536652,5998363,4566222,7753952,29135668,21140775,38759678,1.02490129583,0.928766897972,1.25656305517
2020-07-12,459,135770,,,,,,,418609,323554,537185,6053460,4617850,7813908,29554277,21464329,39296863,1.01828833295,0.926364283375,1.24739134351
2020-07-13,367,136137,,,,,,,418229,323549,536315,6100211,4662935,7864742,29972506,21787878,39833178,1.01211215886,0.923447781426,1.23325292054
2020-07-14,926,137063,,,,,,,417472,323324,534514,6138907,4701467,7906406,30389978,22111202,40367692,1.00638695511,0.922266568254,1.21841333434
2020-07-15,968,138031,,,,,,,416357,322948,532576,6169862,4733898,7938224,30806335,22434150,40900268,1.00110633531,0.919671046096,1.20133539406
2020-07-16,943,138974,,,,,,,414906,321860,530088,6193407,4759831,7959947,31221241,22756010,41430356,0.996253392418,0.917987320618,1.18623483935
2020-07-17,930,139904,,,,,,,413141,320548,527218,6209887,4779693,7973513,31634382,23076558,41957574,0.991809471655,0.916037022677,1.17209668801
2020-07-18,868,140772,,,,,,,411083,319036,524768,6219646,4793997,7978720,32045465,23395594,42482342,0.987756984,0.913848456145,1.15677957054
2020-07-19,447,141219,,,,,,,408753,317660,522048,6223033,4802985,7976918,32454218,23713254,43004390,0.984077815506,0.911772886784,1.14109416564
2020-07-20,514,141733,,,,,,,406173,315241,519294,6220387,4806393,7968693,32860391,24028495,43523684,0.980751343057,0.910731269198,1.12818262165
2020-07-21,1107,142840,,,,,,,403363,312356,516025,6212041,4803858,7954253,33263754,24340851,44039709,0.977754023334,0.909931891763,1.10358460725
2020-07-22,1216,144056,,,,,,,400343,309643,512073,6198322,4795872,7933507,33664097,24650494,44551782,0.97506004506,0.909127380401,1.08498808841
2020-07-23,1094,145150,,,,,,,397134,307143,508451,6179552,4783484,7907540,34061231,24957637,45060233,0.972642135004,0.907596749117,1.06937304641
2020-07-24,1132,146282,,,,,,,393753,304652,504484,6156048,4767062,7876778,34454984,25262289,45564717,0.970472359995,0.905581011383,1.05726521788
2020-07-25,899,147181,,,,,,,390236,301449,500908,6128140,4746530,7841611,34845220,25563738,46065625,0.968523134711,0.904326933864,1.05414344022
2020-07-26,472,147653,,,,,,,386583,298031,496075,6096135,4721627,7801090,35231803,25861769,46561700,0.966768417601,0.903179605859,1.04836701883
2020-07-27,1120,148773,,,,,,,382812,294802,491943,6060338,4692798,7755901,35614615,26156571,47053643,0.965184784379,0.90244022263,1.04020845618
2020-07-28,1374,150147,,,,,,,378937,291198,487448,6021045,4660374,7707090,35993552,26447769,47541091,0.963752023693,0.901771270136,1.03697746675
2020-07-29,1432,151579,,,,,,,374974,287231,482629,5978548,4624215,7655250,36368526,26735000,48023720,0.962453078741,0.901011245306,1.03353739443
2020-07-30,1209,152788,,,,,,,370939,283835,477556,5933130,4585055,7600285,36739465,27018835,48501276,0.96127342686,0.899841400429,1.03177739957
2020-07-31,1243,154031,,,,,,,366841,279958,473397,5885065,4543104,7543655,37106306,27298793,48974673,0.960200203481,0.899377208374,1.02760616129
2020-08-01,1115,155146,,,,,,,362690,276495,468760,5834614,4499016,7485245,37468996,27575288,49443433,0.959221427653,0.898813763507,1.02678517238
2020-08-02,403,155549,,,,,,,358496,272628,463614,5782027,4452589,7424149,37827492,27847916,49907047,0.95832556275,0.897701833326,1.02529573327
2020-08-03,530,156079,,,,,,,354270,268480,458693,5727543,4403396,7360843,38181762,28116396,50365740,0.957501446858,0.89708165498,1.02475857576
2020-08-04,1378,157457,,,,,,,350019,264175,453787,5671389,4352310,7295371,38531781,28380571,50819527,0.956738475279,0.896546387037,1.02420915483
2020-08-05,1376,158833,,,,,,,345751,260084,448942,5613778,4300017,7228311,38877532,28640655,51268469,0.956026870304,0.895012400269,1.0236642184
2020-08-06,1253,160086,,,,,,,341474,256336,444264,5554909,4246689,7160521,39219006,28896991,51712733,0.955357909614,0.893643067632,1.02311840236
2020-08-07,1242,161328,,,,,,,337194,252279,439913,5494969,4191805,7091995,39556200,29149270,52152646,0.95472405117,0.893116477918,1.02256299714
2020-08-08,1077,162405,,,,,,,332918,248039,435003,5434133,4135174,7022523,39889118,29397309,52587649,0.954118948455,0.892572381806,1.02194065656
2020-08-09,511,162916,,,,,,,328899,244288,431085,5372796,4077990,6952703,40218017,29641597,53018734,0.953537380574,0.892084973888,1.02130394921
2020-08-10,527,163443,,,,,,,324888,240461,426962,5311101,4020408,6883600,40542905,29882058,53445696,0.952975130541,0.891676853974,1.02062490454
2020-08-11,1064,164507,,,,,,,320900,236451,422604,5249189,3962051,6814285,40863805,30118509,53868300,0.95242884123,0.891278602117,1.01994459688
2020-08-12,1505,166012,,,,,,,316950,232523,418714,5187202,3903374,6745572,41180755,30351032,54287014,0.951895869959,0.890889602693,1.01926136809
2020-08-13,1070,167082,,,,,,,313066,228695,414927,5125294,3844840,6677889,41493821,30579727,54701941,0.951374154244,0.890509596635,1.01857525954
2020-08-14,1338,168420,,,,,,,309276,225004,411291,5063631,3786012,6611630,41803097,30804731,55113232,0.950862094694,0.890138349555,1.01790374642
2020-08-15,1034,169454,,,,,,,305560,221185,407676,5002350,3727243,6545921,42108657,31025916,55520908,0.950358456722,0.889775646169,1.01743127339
2020-08-16,571,170025,,,,,,,301906,217565,403976,4941567,3668317,6481153,42410563,31243481,55924884,0.949862290275,0.88942128608,1.01677750049
2020-08-17,446,170471,,,,,,,298314,214027,401045,4881384,3609718,6418599,42708877,31457508,56325929,0.949372865541,0.889075080601,1.01625378585
2020-08-18,1325,171796,,,,,,,294787,210548,397971,4821902,3551790,6357893,43003664,31668056,56723900,0.948889622197,0.888736850348,1.01564411054
2020-08-19,1353,173149,,,,,,,291333,206984,394580,4763216,3494603,6298707,43294997,31875040,57118480,0.948412129768,0.888406423435,1.01503108082
2020-08-20,1079,174228,,,,,,,287952,203475,391284,4705417,3438000,6241070,43582949,32078515,57509764,0.947940056917,0.888083634104,1.01441592916
2020-08-21,1105,175333,,,,,,,284641,200223,388415,4648584,3381894,6185237,43867590,32278738,57898179,0.947473147778,0.887768321706,1.01379872358
2020-08-22,982,176315,,,,,,,281397,196889,385058,4592787,3326510,6130390,44148987,32475627,58283237,0.947011203815,0.887460329923,1.01325040366
2020-08-23,450,176765,,,,,,,278219,193787,382176,4538089,3272262,6077567,44427206,32669414,58665413,0.94655406995,0.887159506198,1.01259753369
2020-08-24,442,177207,,,,,,,275283,190889,379667,4484472,3218865,6026149,44702489,32860303,59045080,0.947054334929,0.888168445588,1.01281957147
2020-08-25,1239,178446,,,,,,,272411,187970,377044,4431996,3166377,5976230,44974900,33048273,59422124,0.94756204795,0.887616112814,1.01387273175
2020-08-26,1225,179671,,,,,,,269613,185085,375052,4380709,3115013,5928677,45244513,33233358,59797176,0.948076705244,0.887655877314,1.01478552866
2020-08-27,1111,180782,,,,,,,266894,182231,373230,4330652,3064722,5883186,45511407,33415589,60170406,0.948598259574,0.888276428263,1.01610258433
2020-08-28,971,181753,,,,,,,264271,179319,371488,4281857,3015348,5839733,45775678,33594908,60541894,0.949126652983,0.890113812537,1.01751195227
2020-08-29,958,182711,,,,,,,261762,176356,369156,4234343,2966702,5797578,46037440,33771264,60911050,0.949661813505,0.889824245766,1.01881859972
2020-08-30,310,183021,,,,,,,259352,173786,367356,4188135,2919306,5757237,46296792,33945050,61278406,0.950203629871,0.888272749868,1.02037282846
2020-08-31,573,183594,,,,,,,257032,171168,365578,4143261,2872910,5718818,46553824,34116218,61643984,0.950751946974,0.886870776159,1.02204009179
2020-09-01,1067,184661,,,,,,,254800,168735,364279,4099747,2827615,5682028,46808624,34284953,62008263,0.95130664708,0.885515119277,1.02358548696
2020-09-02,1056,185717,,,,,,,252658,166321,363339,4057617,2783385,5647372,47061282,34451274,62371602,0.951867640792,0.884247482985,1.02544024876
2020-09-03,1070,186787,,,,,,,250610,163841,362539,4016894,2740238,5615303,47311892,34615115,62734141,0.952434839165,0.882750943189,1.02781396322
2020-09-04,965,187752,,,,,,,248658,161614,361468,3977600,2698374,5585461,47560550,34776729,63095609,0.953008151223,0.881413719861,1.02986838108
2020-09-05,783,188535,,,,,,,246797,159524,361486,3939756,2657673,5558508,47807347,34936253,63457095,0.953587468466,0.881285280453,1.0320700976
2020-09-06,403,188938,,,,,,,245028,157406,361472,3903388,2618190,5534890,48052375,35093659,63818567,0.954172681949,0.881080705198,1.03488275857
2020-09-07,267,189205,,,,,,,243350,155257,361442,3868518,2579662,5514120,48295725,35248916,64180009,0.954763688451,0.880398327134,1.03801104212
2020-09-08,445,189650,,,,,,,241764,153253,361643,3835000,2542028,5496068,48537489,35402169,64541652,0.955360387646,0.880193261031,1.03941794606
2020-09-09,1206,190856,,,,,,,240272,151117,361522,3802860,2505177,5480517,48777761,35553286,64903174,0.955962678246,0.879013963171,1.04186686649
2020-09-10,907,191763,,,,,,,238872,149004,361948,3772120,2469098,5467395,49016633,35702290,65265122,0.956570453656,0.876001778335,1.04432488433
2020-09-11,1213,192976,,,,,,,237567,146938,362527,3742793,2433808,5456680,49254200,35849228,65627649,0.957183603325,0.874170768307,1.04577075402
2020-09-12,714,193690,,,,,,,236355,145001,362870,3714877,2399490,5448051,49490555,35994229,65990519,0.95780201543,0.871978459965,1.04885400365
2020-09-13,378,194068,,,,,,,235238,143240,363703,3688353,2366374,5442592,49725793,36137469,66354222,0.958425577229,0.87059359228,1.05034228075
2020-09-14,422,194490,,,,,,,234217,141470,364949,3663218,2334058,5440188,49960010,36278939,66719171,0.959054174312,0.869818133597,1.05366478918
2020-09-15,1288,195778,,,,,,,233292,139695,366064,3639478,2302585,5440683,50193302,36418634,67085235,0.959687689113,0.868908138234,1.05691285608
2020-09-16,983,196761,,,,,,,232465,138048,367464,3617143,2271897,5443880,50425767,36556682,67452699,0.96032600047,0.867627804617,1.0604193147
2020-09-17,870,197631,,,,,,,231737,136361,369102,3596222,2241939,5449657,50657504,36693043,67821801,0.960968984033,0.865716884516,1.06476303394
2020-09-18,936,198567,,,,,,,231108,134921,371265,3576720,2213021,5458397,50888612,36827964,68193066,0.961616512539,0.863827581417,1.06881648796
2020-09-19,712,199279,,,,,,,230581,133481,373757,3558644,2184888,5470702,51119193,36961445,68566823,0.962268455681,0.862090125944,1.07239486008
2020-09-20,227,199506,,,,,,,230157,131900,376269,3542003,2157263,5485505,51349350,37093345,68943092,0.962924679629,0.860188520497,1.07573126524
2020-09-21,356,199862,,,,,,,229837,130325,378912,3526812,2130183,5502953,51579187,37223670,69322004,0.963585046605,0.858568525344,1.07917094487
2020-09-22,921,200783,,,,,,,229622,128820,381908,3513084,2103745,5523416,51808809,37352490,69703912,0.964249414725,0.856567019608,1.08324003685
2020-09-23,1098,201881,,,,,,,229515,127328,385438,3500835,2077822,5547208,52038324,37479818,70089350,0.964917637926,0.854711519202,1.08760490184
2020-09-24,914,202795,,,,,,,229518,126045,389388,3490081,2052755,5575072,52267842,37605863,70478738,0.965589565819,0.852843551307,1.09165780429
2020-09-25,952,203747,,,,,,,229632,124658,392701,3480841,2028416,5605821,52497474,37730521,70871439,0.966265043422,0.85121085348,1.09604518274
2020-09-26,740,204487,,,,,,,229860,123400,396935,3473134,2004884,5640230,52727334,37853921,71268374,0.966943910831,0.849275414224,1.10000226433
2020-09-27,,,727.601588496,488,1033,205214.601588,204975,205520,230203,122120,401738,3466982,1982008,5679101,52957537,37976041,71670112,0.967626002942,0.847534167054,1.1037880714
2020-09-28,,,718.504056239,479,1025,205933.105645,205455,206545,230665,120804,406699,3462409,1959579,5722099,53188202,38096845,72076811,0.968311149193,0.8457104239,1.10729889138
2020-09-29,,,709.756026054,471,1018,206642.861671,205927,207562,231248,119660,412340,3459440,1937774,5769490,53419450,38216505,72489151,0.968999173312,0.843894253278,1.11080373182
2020-09-30,,,701.341449952,462,1011,207344.203121,206390,208573,231954,118500,417633,3458102,1916583,5821058,53651404,38335005,72906784,0.969689893015,0.842085547671,1.11430153089
2020-10-01,,,693.247457775,454,1007,208037.450579,206844,209579,232787,117412,423713,3458423,1895951,5877299,53884191,38452417,73330497,0.970392387856,0.840284199767,1.11779116883
2020-10-02,,,685.463772226,446,1000,208722.914351,207291,210579,233749,116353,429823,3460436,1875947,5938016,54117940,38568770,73760320,0.971101300221,0.838846542706,1.12127146419
2020-10-03,,,677.982224415,438,997,209400.896575,207730,211575,234844,115231,437336,3464171,1856259,6004081,54352784,38684001,74197656,0.971812529783,0.837494611393,1.1247411701
2020-10-04,,,670.800272565,431,994,210071.696848,208161,212568,236075,114192,445938,3469665,1836974,6076255,54588859,38798193,74643594,0.972528682932,0.835887126795,1.12819897018
2020-10-05,,,663.915406826,424,992,210735.612255,208585,213559,237446,113422,454675,3476955,1818499,6154647,54826305,38911615,75098269,0.973251838005,0.833636080601,1.13377354302
2020-10-06,,,657.327407795,416,989,211392.939662,209002,214547,238960,112512,463189,3486078,1800689,6238912,55065265,39024127,75561458,0.973980207539,0.832445246789,1.13630766477
2020-10-07,,,651.038063385,410,986,212043.977726,209412,215532,240622,111749,471508,3497078,1783621,6328492,55305887,39135876,76032966,0.974709719605,0.830073387989,1.13852983536
2020-10-08,,,645.044184451,403,984,212689.02191,209815,216515,242435,111003,480345,3509998,1767300,6423376,55548322,39246879,76513311,0.97544013011,0.829499046916,1.14070179152
2020-10-09,,,639.343214824,396,982,213328.365125,210211,217497,244404,110353,490447,3524883,1751610,6524410,55792726,39357232,77003758,0.976179652128,0.828931124875,1.14282068502
2020-10-10,,,633.932897907,389,980,213962.298023,210601,218476,246532,109781,501691,3541784,1736731,6633369,56039258,39467013,77505449,0.976929575885,0.826497213346,1.14634513031
2020-10-11,,,631.407559866,384,983,214593.705583,210985,219459,248826,109111,513699,3560750,1722439,6750104,56288084,39576124,78019148,0.977683088564,0.826177442101,1.14926527041
2020-10-12,,,629.153134203,379,987,215222.858717,211365,220445,251289,108488,525034,3581836,1708806,6873375,56539373,39684612,78544182,0.978437935036,0.825886844276,1.15209991065
2020-10-13,,,627.17168203,375,991,215850.030399,211741,221436,253928,107926,536988,3605099,1695929,7003640,56793301,39792538,79081170,0.979196257511,0.825600560812,1.15503766307
2020-10-14,,,625.465730032,371,996,216475.496129,212112,222431,256746,107545,550268,3630597,1683815,7141550,57050047,39900083,79631438,0.979957554005,0.824465315618,1.1581564703
2020-10-15,,,624.038130024,367,1001,217099.534259,212480,223431,259749,107150,563874,3658392,1672465,7287776,57309796,40007233,80195312,0.980739941439,0.823373383323,1.16072260965
2020-10-16,,,622.89208614,363,1008,217722.426345,212844,224439,262943,106750,578427,3688548,1661804,7442478,57572739,40113983,80773739,0.981528700024,0.822862511933,1.16355975199
2020-10-17,,,622.031202827,359,1016,218344.457548,213203,225454,266332,106267,593376,3721131,1651723,7606021,57839071,40220250,81367115,0.982318120631,0.822473295135,1.16656468075
2020-10-18,,,621.459412434,356,1024,218965.91696,213560,226477,269922,105902,610013,3756210,1642398,7778683,58108993,40326152,81977128,0.983107516764,0.822323961905,1.16954317387
2020-10-19,,,621.181099562,352,1033,219587.09806,213913,227509,273717,105599,627112,3793852,1633811,7959844,58382710,40431751,82604240,0.983897201302,0.822532527931,1.17249321525
2020-10-20,,,621.2010048,348,1041,220208.299065,214262,228549,277721,105363,642335,3834127,1625760,8147487,58660431,40537114,83246575,0.984688133084,0.821749015214,1.17541267394
2020-10-21,,,621.524229733,345,1052,220829.823295,214607,229600,281939,105137,659050,3877106,1618393,8343336,58942370,40642251,83905625,0.985483474314,0.820512845395,1.1782992973
2020-10-22,,,622.156253832,341,1063,221451.979548,214950,230662,286377,104936,677259,3922862,1611589,8549069,59228747,40747187,84582884,0.986297766406,0.820514947393,1.18115070386
2020-10-23,,,623.10296465,338,1074,222075.082513,215288,231735,291038,104756,696143,3971465,1605351,8764850,59519785,40851943,85279027,0.987112449987,0.820008911312,1.18410254506
2020-10-24,,,624.361925085,335,1086,222699.444438,215624,232820,295925,104609,715513,4022987,1599615,8989909,59815710,40956552,85994540,0.987925318565,0.819505623891,1.18697329028
2020-10-25,,,625.940673328,332,1101,223325.385111,215956,233920,301043,104553,736130,4077497,1594389,9224338,60116753,41061105,86730670,0.988738128558,0.818782583301,1.18980397425
2020-10-26,,,627.847155413,329,1115,223953.232267,216286,235034,306395,104646,757438,4135067,1589927,9468065,60423148,41165751,87488108,0.989550905431,0.817828841089,1.19259174317
2020-10-27,,,630.089746955,326,1131,224583.322014,216612,236163,311984,104445,779201,4195761,1585886,9722212,60735132,41270196,88267309,0.990357214831,0.817524252276,1.19534411838
2020-10-28,,,632.677286083,323,1149,225215.9993,216936,237310,317806,104454,801369,4259639,1582421,9986579,61052938,41374650,89068678,0.991159433446,0.817260564579,1.19841202292
2020-10-29,,,635.619114302,320,1166,225851.618414,217257,238474,323868,104659,824749,4326762,1579542,10261043,61376806,41479309,89893427,0.991960235475,0.816998420566,1.20174148725
2020-10-30,,,638.925078817,317,1185,226490.543493,217575,239657,330169,104887,849656,4397182,1577285,10546813,61706975,41584196,90743083,0.992757676059,0.816737768326,1.20515742273
2020-10-31,,,642.605534141,315,1209,227133.149027,217891,240864,336714,105054,874171,4470953,1575597,10842551,62043689,41689250,91617254,0.993546011132,0.816649723207,1.20869642055
2020-11-01,,,646.671343507,313,1233,227779.820371,218205,242095,343498,105166,898920,4548119,1574508,11148085,62387187,41794416,92516174,0.994327522125,0.816503771061,1.21068242956
