date,actual_deaths,total_deaths,predicted_deaths_mean,predicted_deaths_lower,predicted_deaths_upper,predicted_total_deaths_mean,predicted_total_deaths_lower,predicted_total_deaths_upper,predicted_new_infected_mean,predicted_new_infected_lower,predicted_new_infected_upper,predicted_current_infected_mean,predicted_current_infected_lower,predicted_current_infected_upper,predicted_total_infected_mean,predicted_total_infected_lower,predicted_total_infected_upper,r_values_mean,r_values_lower,r_values_upper
2020-02-05,0,0,,,,,,,125,65,178,125,65,178,125,65,178,2.26457354476,2.1,2.4
2020-02-06,0,0,,,,,,,125,65,178,250,131,356,250,130,356,2.26456388084,2.09998972779,2.39999969388
2020-02-07,0,0,,,,,,,125,65,178,375,197,534,375,195,534,2.26456061592,2.09998626609,2.39999953124
2020-02-08,0,0,,,,,,,125,65,178,500,263,712,500,260,712,2.2645562356,2.09998163745,2.39999928501
2020-02-09,0,0,,,,,,,288,164,404,788,443,1104,788,424,1116,2.2645503539,2.09997544838,2.39999890983
2020-02-10,0,0,,,,,,,288,164,404,1076,614,1503,1076,588,1520,2.26454244931,2.09996717267,2.39999832942
2020-02-11,0,0,,,,,,,288,164,404,1365,781,1905,1364,752,1924,2.26453181641,2.09995610665,2.39999743608
2020-02-12,0,0,,,,,,,288,164,404,1653,948,2307,1652,916,2328,2.26451749985,2.09994187753,2.39999613462
2020-02-13,0,0,,,,,,,452,274,631,2105,1239,2918,2104,1190,2959,2.26449820428,2.09992255772,2.39999422112
2020-02-14,0,0,,,,,,,660,404,923,2765,1648,3836,2764,1594,3882,2.26444252302,2.09986174616,2.39996741851
2020-02-15,0,0,,,,,,,1197,741,1615,3962,2444,5412,3961,2335,5497,2.26440365612,2.09981877949,2.39996022601
2020-02-16,0,0,,,,,,,2393,1459,3082,6355,4032,8432,6354,3794,8579,2.26434401846,2.09975794992,2.39994349293
2020-02-17,0,0,,,,,,,3880,2514,4913,10235,6680,13260,10234,6308,13492,2.26426760452,2.09968016614,2.39992352156
2020-02-18,0,0,,,,,,,4299,2828,5452,14534,9547,18685,14533,9136,18944,2.26416740885,2.09957902639,2.39989903065
2020-02-19,0,0,,,,,,,5043,3375,6396,19577,12983,25035,19576,12511,25340,2.26403420964,2.09944627015,2.39986605094
2020-02-20,0,0,,,,,,,5183,3479,6589,24636,16407,31437,24759,15990,31929,2.26385467889,2.09927160616,2.39982016968
2020-02-21,0,0,,,,,,,5712,3896,7258,30223,20260,38496,30471,19886,39187,2.26361108469,2.09903872759,2.39975511462
2020-02-22,0,0,,,,,,,6757,4681,8589,36855,24921,46867,37228,24567,47776,2.26328317573,2.09873110918,2.3996623403
2020-02-23,0,0,,,,,,,8096,5705,10274,44826,30652,56888,45324,30272,58050,2.26284180965,2.09832677349,2.39951598774
2020-02-24,0,0,,,,,,,10276,7219,13111,54814,37785,69536,55600,37491,71161,2.26224530198,2.09782210982,2.39932896702
2020-02-25,0,0,,,,,,,16158,10787,20567,70683,48587,89584,71758,48278,91728,2.26143639931,2.09717937798,2.39905605387
2020-02-26,0,0,,,,,,,19538,13271,24929,89933,61739,114070,91296,61549,116657,2.26033633277,2.09634484872,2.39864663672
2020-02-27,0,0,,,,,,,21294,14353,27400,110938,75940,141051,112590,75902,144057,2.25883856693,2.09525058393,2.39805125767
2020-02-28,0,0,,,,,,,25876,17266,33715,136363,92930,174123,138466,93168,177772,2.25679674445,2.09370924973,2.39721403492
2020-02-29,1,1,,,,,,,31667,20585,41891,167370,113118,215045,170133,113753,219663,2.25400926647,2.09163627628,2.39595431561
2020-03-01,0,1,,,,,,,41162,26172,55095,207334,138610,268407,211295,139925,274758,2.25019978406,2.08892967793,2.39409162402
2020-03-02,5,6,,,,,,,51204,32216,69180,256146,169472,334352,262499,172141,343938,2.2449916192,2.08529589381,2.3913447372
2020-03-03,1,7,,,,,,,63550,39850,86562,315816,206899,415852,326049,211991,430500,2.23787544872,2.08018077034,2.3872926206
2020-03-04,4,11,,,,,,,77994,48294,107343,389512,252462,517569,404043,260285,537843,2.22816908765,2.0725220646,2.38131927961
2020-03-05,1,12,,,,,,,97576,59733,135663,482045,308922,646633,501619,320018,673506,2.21497220898,2.06367592291,2.37264930291
2020-03-06,2,14,,,,,,,119597,72491,168236,596458,378043,808028,621216,392509,841742,2.19712362248,2.05147526532,2.36023279756
2020-03-07,3,17,,,,,,,144514,87777,203712,735260,461996,1004291,765730,480286,1045454,2.17317620909,2.02974306514,2.34218150775
2020-03-08,4,21,,,,,,,171770,105627,240505,900273,562931,1236108,937500,585913,1285959,2.14141734626,1.99968198176,2.31509946317
2020-03-09,1,22,,,,,,,200629,126794,275787,1092805,683896,1501657,1138129,712707,1561746,2.09997640799,1.94298978981,2.27855844458
2020-03-10,6,28,,,,,,,230035,151853,311506,1312564,828280,1800193,1368164,864560,1873252,2.047066545,1.8682729647,2.25864855961
2020-03-11,5,33,,,,,,,256250,173437,343337,1552657,990894,2122918,1624414,1037997,2216589,1.98138280761,1.78385164859,2.22044196266
2020-03-12,10,43,,,,,,,277697,188990,370407,1810815,1166484,2468409,1902111,1226987,2586996,1.90260165351,1.68665116769,2.18308408414
2020-03-13,8,51,,,,,,,294187,203476,389857,2083708,1355501,2830829,2196298,1430463,2976853,1.81181682921,1.57117048812,2.11136740008
2020-03-14,7,58,,,,,,,305520,210722,400806,2363352,1548883,3197841,2501818,1641185,3377659,1.71169141784,1.45666534968,2.04553562333
2020-03-15,12,70,,,,,,,313035,217515,411572,2644720,1745886,3567355,2814853,1858700,3789231,1.60619670836,1.33596253706,1.97741133843
2020-03-16,27,97,,,,,,,317191,222611,421983,2920749,1942552,3934000,3132044,2081311,4211214,1.5000038617,1.21904616914,1.89099742759
2020-03-17,35,132,,,,,,,318885,226395,426650,3188430,2137098,4291181,3450929,2307706,4637864,1.39774061389,1.12484869105,1.78410479303
2020-03-18,59,191,,,,,,,318983,230190,427152,3443862,2328064,4631407,3769912,2537896,5065016,1.30333598013,1.05223709746,1.66552095451
2020-03-19,73,264,,,,,,,318004,232834,424292,3683872,2513473,4947830,4087916,2770730,5489308,1.21958953576,1.00087597551,1.54477247579
2020-03-20,99,363,,,,,,,316415,234902,422529,3902711,2689797,5233972,4404331,3005632,5911837,1.14800119464,0.964482533788,1.44277905113
2020-03-21,99,462,,,,,,,314316,236625,419882,4097431,2855269,5484904,4718647,3242257,6331719,1.08883466178,0.939477799448,1.34143287038
2020-03-22,110,572,,,,,,,311798,237524,415380,4264715,3006544,5695867,5030445,3479781,6747099,1.04135934923,0.922415707343,1.25801172529
2020-03-23,189,761,,,,,,,308990,237793,409884,4401935,3140361,5864550,5339435,3717574,7156983,1.00419423425,0.901236187625,1.18689533104
2020-03-24,239,1000,,,,,,,305927,237001,402296,4507233,3252207,5990240,5645362,3954575,7559279,0.97566105076,0.882655494334,1.12461019969
2020-03-25,324,1324,,,,,,,302638,233983,395222,4579836,3335609,6072978,5948000,4188558,7954501,0.954067399799,0.869402413173,1.07217875791
2020-03-26,408,1732,,,,,,,299107,232080,389115,4622693,3395312,6117842,6247107,4420638,8343616,0.937884087767,0.860014140505,1.03466888323
2020-03-27,518,2250,,,,,,,295315,230523,382749,4640310,3437458,6129296,6542422,4651161,8726365,0.925825064594,0.853463392622,1.0050854777
2020-03-28,633,2883,,,,,,,291260,227065,375456,4637384,3461148,6114160,6833682,4878226,9101821,0.916860047039,0.848960261809,0.984028931776
2020-03-29,586,3469,,,,,,,286979,223475,367931,4618842,3473236,6080583,7120661,5101701,9469752,0.910190632554,0.845707876378,0.971488959689
2020-03-30,692,4161,,,,,,,282417,218980,360571,4588224,3473548,6029257,7403078,5320681,9830323,0.905212032504,0.843279149726,0.96238284358
2020-03-31,1085,5246,,,,,,,277626,214399,353096,4548659,3463739,5960526,7680704,5535080,10183419,0.901473169705,0.841525806058,0.95694618597
2020-04-01,1172,6418,,,,,,,272624,209870,345559,4502398,3445400,5880010,7953328,5744950,10528978,0.898641106752,0.840354655359,0.95259308892
2020-04-02,1503,7921,,,,,,,267439,205408,338521,4450854,3418949,5792287,8220767,5950358,10867499,0.896471788869,0.839412577599,0.94904228212
2020-04-03,1392,9313,,,,,,,262099,201167,332182,4394948,3385743,5701157,8482866,6151525,11199681,0.894787091156,0.838376268005,0.946504899366
2020-04-04,1523,10836,,,,,,,256632,196620,325210,4335166,3346144,5604881,8739498,6348145,11524891,0.893457337136,0.83744875175,0.944496402518
2020-04-05,1590,12426,,,,,,,251074,191903,318119,4271924,3300402,5504379,8990572,6540048,11843010,0.89238823721,0.83685147555,0.942955409392
2020-04-06,1770,14196,,,,,,,245463,187225,311330,4205588,3249428,5401651,9236035,6727273,12154340,0.891511251229,0.836324496291,0.941686512268
2020-04-07,2571,16767,,,,,,,239835,182887,304462,4136434,3194114,5297450,9475870,6910160,12458802,0.89077653532,0.835748909749,0.940907347877
2020-04-08,2146,18913,,,,,,,234228,178475,297677,4064735,3135336,5193808,9710098,7088635,12756479,0.890147806803,0.835114118964,0.940193411736
2020-04-09,2228,21141,,,,,,,228673,173941,290769,3990770,3075060,5090094,9938771,7262576,13047248,0.889598617478,0.834692863853,0.939583285458
2020-04-10,2218,23359,,,,,,,223195,169729,284149,3914858,3012552,4985715,10161966,7432305,13331397,0.88910965386,0.834246750413,0.939030827796
2020-04-11,2119,25478,,,,,,,217815,165239,277320,3837358,2947151,4880708,10379781,7597544,13608717,0.888664259378,0.83394856677,0.938593671746
2020-04-12,1816,27294,,,,,,,212548,161133,271143,3758645,2881123,4776675,10592329,7758677,13879860,0.888255863573,0.833509558538,0.938147016076
2020-04-13,1946,29240,,,,,,,207403,157072,264867,3679070,2814660,4673766,10799732,7915749,14144727,0.887875671697,0.833187765135,0.937733935372
2020-04-14,2455,31695,,,,,,,202388,153133,258762,3599041,2748774,4572035,11002120,8068882,14403489,0.887517212188,0.832880340931,0.937383093278
2020-04-15,2609,34304,,,,,,,197502,149011,253008,3518918,2683371,4471976,11199622,8217893,14656497,0.887186186049,0.832537901964,0.937024415077
2020-04-16,2176,36480,,,,,,,192748,145189,247519,3439041,2618693,4373941,11392370,8363082,14904016,0.886868743628,0.832251467697,0.936601626784
2020-04-17,2093,38573,,,,,,,188122,141504,242203,3359725,2554799,4277626,11580492,8504586,15146219,0.886568271442,0.831978044707,0.93632432049
2020-04-18,1960,40533,,,,,,,183622,137753,237096,3281248,2491406,4182543,11764114,8642339,15383315,0.886282493652,0.831679012827,0.93602949417
2020-04-19,1931,42464,,,,,,,179244,133977,232014,3203859,2428784,4089376,11943358,8776316,15615329,0.8860120331,0.831379889732,0.935752562367
2020-04-20,2186,44650,,,,,,,174984,130279,227179,3127769,2367179,3998487,12118342,8906595,15842508,0.8857566021,0.831109564314,0.935489744416
2020-04-21,2548,47198,,,,,,,170839,126834,222593,3053146,2306802,3909804,12289181,9033429,16065101,0.885516598084,0.830876135805,0.935240585526
2020-04-22,2434,49632,,,,,,,166805,123283,218133,2980115,2247199,3823558,12455986,9156712,16283234,0.885293191456,0.830657186838,0.935021758609
2020-04-23,2466,52098,,,,,,,162879,119849,213625,2908766,2188566,3739609,12618865,9276561,16496859,0.885089796787,0.830476380891,0.934747649819
2020-04-24,2154,54252,,,,,,,159060,116469,209465,2839153,2131075,3658419,12777925,9393030,16706324,0.884910669861,0.830363303717,0.934485556814
2020-04-25,1698,55950,,,,,,,155346,113314,205376,2771304,2074630,3579751,12933271,9506344,16911700,0.884761532127,0.830238892516,0.934244040092
2020-04-26,1329,57279,,,,,,,151734,110179,201387,2705223,2019538,3503921,13085005,9616523,17113087,0.884650775338,0.830104120142,0.933999615432
2020-04-27,1466,58745,,,,,,,148222,107132,197550,2640897,1965504,3430414,13233227,9723655,17310637,0.884589135551,0.830034021024,0.933791482828
2020-04-28,2241,60986,,,,,,,144809,104132,193788,2578303,1912535,3359403,13378036,9827787,17504425,0.884591316782,0.83001528117,0.933756801188
2020-04-29,2521,63507,,,,,,,141495,101219,190036,2517411,1860591,3290732,13519531,9929006,17694461,0.884676954208,0.82995171527,0.933654835353
2020-04-30,2322,65829,,,,,,,138279,98385,186377,2458187,1809939,3224145,13657810,10027391,17880838,0.88487196172,0.829940021506,0.933577878734
2020-05-01,1891,67720,,,,,,,135163,95663,182963,2400602,1760390,3159617,13792973,10123054,18063801,0.885210217378,0.829984041035,0.933446477532
2020-05-02,1692,69412,,,,,,,132145,93067,179746,2344625,1711930,3097178,13925118,10216121,18243547,0.885735471794,0.830026918791,0.933753718336
2020-05-03,1120,70532,,,,,,,129226,90459,176527,2290229,1664616,3036614,14054344,10306580,18420074,0.886503088216,0.830249640968,0.934203437576
2020-05-04,1333,71865,,,,,,,126409,87942,173386,2237394,1618560,2977981,14180753,10394522,18593460,0.887581331707,0.830435546934,0.934586936394
2020-05-05,2318,74183,,,,,,,123698,85583,170301,2186108,1573840,2921090,14304451,10480105,18763761,0.889051321977,0.830649269143,0.935732612265
2020-05-06,2364,76547,,,,,,,121096,83282,167333,2136365,1530265,2865816,14425547,10563387,18931094,0.891004600235,0.830997595794,0.940051925664
2020-05-07,1934,78481,,,,,,,118605,81123,164650,2088164,1488085,2812315,14544152,10644510,19095744,0.893537164909,0.831164009622,0.953681287807
2020-05-08,1747,80228,,,,,,,116232,79021,161953,2041517,1447242,2760629,14660384,10723531,19257697,0.896739580607,0.831821007659,0.969628406974
2020-05-09,1488,81716,,,,,,,113984,76977,159456,1996442,1407737,2710603,14774368,10800508,19417153,0.90068481543,0.83218780865,0.988496758614
2020-05-10,893,82609,,,,,,,111869,75094,157251,1952965,1369505,2662462,14886237,10875602,19574404,0.905418488265,0.832824262826,1.0161634072
2020-05-11,1014,83623,,,,,,,109898,73411,155146,1911129,1332727,2616203,14996135,10949013,19729550,0.910957851215,0.833120191849,1.04828388775
2020-05-12,1627,85250,,,,,,,108080,71804,153252,1870988,1297389,2571885,15104215,11020817,19882802,0.917302505087,0.834107231905,1.07541669608
2020-05-13,1764,87014,,,,,,,106430,70386,151571,1832609,1263636,2529645,15210645,11091203,20034373,0.924451479433,0.835139291949,1.10055399654
2020-05-14,1783,88797,,,,,,,104960,69093,150042,1796074,1231507,2489628,15315605,11160296,20184415,0.932415187906,0.836082054567,1.12396592128
2020-05-15,1681,90478,,,,,,,103685,67988,148646,1761480,1201111,2451880,15419290,11228284,20333061,0.9412150213,0.8381298686,1.14530726941
2020-05-16,1216,91694,,,,,,,102620,67045,147595,1728937,1172498,2416494,15521910,11295329,20480656,0.950874581831,0.840662190434,1.1631392333
2020-05-17,758,92452,,,,,,,101777,66216,146687,1698570,1145661,2383422,15623687,11361545,20627343,0.961411045525,0.844211182334,1.1761146938
2020-05-18,1172,93624,,,,,,,101172,65573,146081,1670516,1120793,2352962,15724859,11427118,20773424,0.9728266145,0.849063516034,1.19410260821
2020-05-19,1552,95176,,,,,,,100816,65069,145809,1644923,1097944,2325367,15825675,11492187,20919233,0.98509043678,0.855642094199,1.22656507975
2020-05-20,1526,96702,,,,,,,100724,64801,146017,1621948,1077195,2301060,15926399,11556988,21065250,0.998107826998,0.864470515353,1.23635606267
2020-05-21,1217,97919,,,,,,,100904,64810,146597,1601756,1058769,2280304,16027303,11621798,21211847,1.01169313378,0.874788543211,1.25259587175
2020-05-22,1244,99163,,,,,,,101367,65105,147437,1584519,1042811,2263074,16128670,11686903,21359284,1.02557287102,0.875647101613,1.25707808361
2020-05-23,1109,100272,,,,,,,102125,65463,148394,1570411,1029320,2249497,16230795,11752366,21507678,1.03943089884,0.875754218146,1.26029820158
2020-05-24,622,100894,,,,,,,103185,65924,149977,1559612,1018337,2239991,16333980,11818290,21657655,1.05297801818,0.876027252137,1.26226702802
2020-05-25,548,101442,,,,,,,104556,66794,151833,1552299,1010107,2234540,16438536,11885084,21809488,1.06601011304,0.87651021343,1.27719953833
2020-05-26,662,102104,,,,,,,106257,67883,153990,1548658,1004652,2233344,16544793,11952967,21963478,1.07842675265,0.877589593921,1.29634254397
2020-05-27,1518,103622,,,,,,,108295,69214,156415,1548873,1002126,2236462,16653088,12022181,22119893,1.09020900494,0.879207285922,1.30544648258
2020-05-28,1178,104800,,,,,,,110675,70921,159493,1553118,1002719,2244329,16763763,12093102,22279386,1.10137847829,0.881374463893,1.31156972989
2020-05-29,1160,105960,,,,,,,113408,72884,162995,1561566,1006560,2257217,16877171,12165986,22442381,1.11196250387,0.883911701649,1.32093353589
2020-05-30,963,106923,,,,,,,116506,75134,166784,1574387,1013747,2275293,16993677,12241120,22609165,1.12201472133,0.887239703279,1.33041666921
2020-05-31,581,107504,,,,,,,119984,77680,171147,1591751,1024419,2298783,17113661,12318800,22780312,1.13158161572,0.891664338863,1.3394801722
2020-06-01,776,108280,,,,,,,123862,80543,175925,1613836,1038776,2327964,17237523,12399343,22956237,1.14072199359,0.899140045878,1.34595503308
2020-06-02,1068,109348,,,,,,,128151,83648,181696,1640815,1056867,2363502,17365674,12482991,23137933,1.14944988677,0.908582917107,1.34942196851
2020-06-03,1007,110355,,,,,,,132870,87200,187742,1672868,1079003,2405359,17498544,12570191,23325675,1.15774816762,0.921388097055,1.35251907117
2020-06-04,1023,111378,,,,,,,138037,91099,193898,1710181,1105296,2453163,17636581,12661290,23519573,1.16555065505,0.930761201998,1.35511114184
2020-06-05,914,112292,,,,,,,143667,95297,201840,1752943,1135784,2508326,17780248,12756587,23721413,1.17279643734,0.936733630015,1.35557036376
2020-06-06,659,112951,,,,,,,149776,99725,210051,1801353,1170406,2570854,17930024,12856312,23931464,1.1794357447,0.941456739022,1.35546966678
2020-06-07,438,113389,,,,,,,156384,104662,218766,1855612,1209604,2641147,18086408,12960974,24150230,1.18540271058,0.948571958921,1.35589033485
2020-06-08,519,113908,,,,,,,163501,109980,227867,1915928,1253653,2718949,18249909,13070954,24378097,1.19066300567,0.957838327055,1.35512464544
2020-06-09,950,114858,,,,,,,171139,115851,237985,1982511,1302699,2805020,18421048,13186805,24616082,1.19515118674,0.968357562821,1.35597229393
2020-06-10,901,115759,,,,,,,179306,121974,248872,2055560,1356783,2899828,18600354,13308779,24864954,1.19883074685,0.98442314272,1.35504510742
2020-06-11,871,116630,,,,,,,188003,128329,260616,2135268,1415886,3003959,18788357,13437108,25125570,1.20167590201,1.00768953407,1.3550399178
2020-06-12,828,117458,,,,,,,197224,135103,273170,2221817,1480051,3117559,18985581,13572211,25398740,1.20364897127,1.03467559423,1.35508750049
2020-06-13,759,118217,,,,,,,206960,142336,286521,2315369,1549487,3241019,19192541,13714547,25685261,1.20473409224,1.05403588415,1.35389926132
2020-06-14,308,118525,,,,,,,217186,149953,299788,2416049,1624286,3373993,19409727,13864500,25985049,1.20487980161,1.05041153798,1.35430652217
2020-06-15,394,118919,,,,,,,227870,157732,314702,2523935,1704310,3517531,19637597,14022232,26299751,1.204080576,1.04851039807,1.35320740514
2020-06-16,838,119757,,,,,,,238965,166103,329764,2639038,1789840,3671389,19876562,14188335,26629515,1.20230397421,1.0393746517,1.35254255879
2020-06-17,744,120501,,,,,,,250410,174478,343627,2761297,1880632,3833358,20126972,14362813,26973142,1.19955546477,1.03113241797,1.35089222025
2020-06-18,718,121219,,,,,,,262131,183330,357918,2890559,1976722,4003616,20389103,14546143,27331060,1.195847714,1.02466135497,1.35008350249
2020-06-19,670,121889,,,,,,,274040,192861,372512,3026563,2078451,4182374,20663143,14739004,27703572,1.1911848737,1.01269518183,1.35049416684
2020-06-20,604,122493,,,,,,,286034,202196,387591,3168930,2185334,4368282,20949177,14941200,28091163,1.18558590474,1.00492016797,1.35281712074
2020-06-21,285,122778,,,,,,,297997,211942,401965,3317151,2297540,4560324,21247174,15153142,28493128,1.1790691959,0.996250845801,1.35294504948
2020-06-22,389,123167,,,,,,,309805,221976,415478,3470572,2414840,4757121,21556979,15375118,28908606,1.17172939607,0.987702876416,1.35335648973
2020-06-23,847,124014,,,,,,,321329,231101,427963,3628401,2535938,4957263,21878308,15606219,29336569,1.16368884275,0.982657984831,1.35289013933
2020-06-24,759,124773,,,,,,,332444,240223,440800,3789705,2660292,5160095,22210752,15846442,29777369,1.15509813676,0.977411124215,1.35249634379
2020-06-25,551,125324,,,,,,,343033,249130,451720,3953432,2787424,5362911,22553785,16095572,30229089,1.14612019417,0.973026062779,1.35295142618
2020-06-26,617,125941,,,,,,,352999,257702,463360,4118428,2916777,5565577,22906784,16353274,30692449,1.1368864523,0.966544147947,1.3517566305
2020-06-27,504,126445,,,,,,,362266,265891,474335,4283470,3047547,5766642,23269050,16619165,31166784,1.12754063965,0.959068224307,1.35135499284
2020-06-28,273,126718,,,,,,,370779,273447,482758,4447289,3178651,5962771,23639829,16892612,31649542,1.11819598973,0.955874002113,1.35022480772
2020-06-29,377,127095,,,,,,,378505,280461,490552,4608608,3309154,6153392,24018334,17173073,32140094,1.10895468086,0.951047065745,1.34649375461
2020-06-30,625,127720,,,,,,,385428,286201,497453,4766165,3437633,6336025,24403762,17459274,32637547,1.09989070223,0.946519193778,1.34391871806
2020-07-01,694,128414,,,,,,,391548,291846,504495,4918748,3563397,6510711,24795310,17751120,33142042,1.09103163634,0.94250384712,1.34207383665
2020-07-02,727,129141,,,,,,,396876,296491,510292,5065214,3685434,6677401,25192186,18047611,33652334,1.08237966298,0.93889684386,1.33556030669
2020-07-03,660,129801,,,,,,,401436,300598,515937,5204520,3802717,6835497,25593622,18348209,34168271,1.07390246597,0.934388421393,1.32566581106
2020-07-04,265,130066,,,,,,,405262,304113,520184,5335741,3914002,6983251,25998884,18652322,34688455,1.06557617167,0.929263661185,1.31314398673
2020-07-05,288,130354,,,,,,,408392,306791,523187,5458099,4018627,7118925,26407276,18959113,35211642,1.05738947849,0.927032954699,1.30931828847
2020-07-06,355,130709,,,,,,,410868,309217,526079,5570970,4115927,7243109,26818144,19268330,35737721,1.04935234552,0.923725052337,1.29814514117
2020-07-07,1222,131931,,,,,,,412734,311450,527462,5673899,4205422,7355111,27230878,19579780,36265183,1.04149315804,0.920122019333,1.28670710889
2020-07-08,863,132794,,,,,,,414031,313401,529614,5766600,4287749,7456776,27644909,19893181,36794797,1.03385563176,0.915577580132,1.27939109717
2020-07-09,1003,133797,,,,,,,414800,314622,530543,5848956,4362151,7546530,28059709,20207803,37325340,1.02649032876,0.913186534835,1.27233385001
2020-07-10,824,134621,,,,,,,415077,315161,530443,5921000,4428177,7625242,28474786,20522964,37855783,1.01944945892,0.911219519026,1.26228473635
2020-07-11,690,135311,,,,,,,414898,315578,529919,5982898,4486064,7691783,28889684,20838542,38385702,1.01278586858,0.909411154991,1.25032455593
2020-07-12,459,135770,,,,,,,414296,315607,529096,6034928,4535790,7746533,29303980,21154149,38914798,1.00654596129,0.905888115311,1.23584621413
2020-07-13,367,136137,,,,,,,413304,314849,527025,6077453,4577211,7790806,29717284,21468998,39441823,1.00075952943,0.903922550229,1.21828790004
2020-07-14,926,137063,,,,,,,411949,314205,525391,6110897,4610981,7825642,30129233,21783203,39967214,0.995433490244,0.903026899192,1.20147471753
2020-07-15,968,138031,,,,,,,410259,312949,522802,6135728,4637762,7851010,30539492,22096152,40490016,0.990554727742,0.901442808534,1.18715066477
2020-07-16,943,138974,,,,,,,408259,311800,520152,6152439,4657750,7866707,30947751,22407952,41010168,0.986099559965,0.898817475708,1.17831152986
2020-07-17,930,139904,,,,,,,405972,310669,517605,6161535,4671967,7874071,31353723,22718621,41527773,0.982042580104,0.896639152984,1.15852987428
2020-07-18,868,140772,,,,,,,403422,308930,514176,6163521,4680337,7872380,31757145,23027551,42041949,0.978360235608,0.895710129567,1.14087300875
2020-07-19,447,141219,,,,,,,400631,306947,510705,6158890,4683210,7862978,32157776,23334498,42552654,0.975030134318,0.893734288827,1.13188242997
2020-07-20,514,141733,,,,,,,397619,304873,507082,6148117,4681321,7846948,32555395,23639371,43059736,0.972029470583,0.891867785383,1.10794905393
2020-07-21,1107,142840,,,,,,,394405,302487,503073,6131654,4674600,7823983,32949800,23941858,43562809,0.969334383242,0.890765562678,1.09071486649
2020-07-22,1216,144056,,,,,,,391011,299876,499227,6109931,4663022,7795763,33340811,24241734,44062036,0.966920005833,0.889527853891,1.07009911616
2020-07-23,1094,145150,,,,,,,387452,297149,495174,6083353,4646742,7761349,33728263,24538883,44557210,0.964760639835,0.888789596097,1.05594522712
2020-07-24,1132,146282,,,,,,,383748,294180,490065,6052301,4626252,7720900,34112011,24833063,45047275,0.962830075031,0.887965662743,1.04618981854
2020-07-25,899,147181,,,,,,,380180,291408,485767,6017405,4602433,7676250,34492191,25124471,45533042,0.961102292705,0.885946622251,1.04102623718
2020-07-26,472,147653,,,,,,,376488,288496,481309,5978996,4575278,7627673,34868679,25412967,46014351,0.959552496192,0.885232380549,1.03806102647
2020-07-27,1120,148773,,,,,,,372699,285840,476712,5937399,4545429,7575316,35241378,25698807,46491063,0.95815812448,0.884549387012,1.03511662783
2020-07-28,1374,150147,,,,,,,368838,282697,472157,5892933,4513186,7520500,35610216,25981504,46963220,0.956899482493,0.883819052396,1.03232688696
2020-07-29,1432,151579,,,,,,,364944,279649,467540,5845928,4478550,7462709,35975160,26261153,47430760,0.955759806328,0.88300019715,1.02909497354
2020-07-30,1209,152788,,,,,,,361052,276315,462981,5796721,4441837,7402964,36336212,26537468,47893741,0.954724828059,0.882241236487,1.02705331442
2020-07-31,1243,154031,,,,,,,357152,273036,458258,5745614,4402996,7341149,36693364,26810504,48351999,0.953782089975,0.881529702354,1.02605179235
2020-08-01,1115,155146,,,,,,,353237,270117,453817,5692879,4362381,7277436,37046601,27080621,48805816,0.9529203023,0.880856490689,1.024156295
2020-08-02,403,155549,,,,,,,349317,266936,449295,5638773,4320339,7212632,37395918,27347557,49255111,0.95212894124,0.880213272545,1.02356021684
2020-08-03,530,156079,,,,,,,345399,263682,444882,5583541,4277025,7146870,37741317,27611239,49699993,0.951398126391,0.879535515839,1.02283600828
2020-08-04,1378,157457,,,,,,,341499,260132,440410,5527422,4232247,7080250,38082816,27871371,50140403,0.95071957359,0.878369002604,1.02214932635
2020-08-05,1376,158833,,,,,,,337622,256928,436479,5470638,4186655,7013683,38420438,28128299,50576882,0.950084108829,0.877629407308,1.02131953676
2020-08-06,1253,160086,,,,,,,333771,253538,432181,5413399,4140285,6946661,38754209,28381837,51009063,0.949484427974,0.877119613919,1.0203746042
2020-08-07,1242,161328,,,,,,,329948,250031,428570,5355895,4093142,6880083,39084157,28631868,51437633,0.948914275056,0.876623056818,1.01972667504
2020-08-08,1077,162405,,,,,,,326157,246450,424606,5298304,4045391,6814647,39410314,28878318,51862239,0.948368420964,0.876139365726,1.01907616975
2020-08-09,511,162916,,,,,,,322706,243193,420972,5240830,3997159,6749874,39733020,29121511,52283211,0.94978623314,0.876746616372,1.02078921526
2020-08-10,527,163443,,,,,,,319292,239713,417410,5183634,3948363,6686001,40052312,29361224,52700621,0.951224101319,0.877211489146,1.02074994161
2020-08-11,1064,164507,,,,,,,315931,236267,413923,5126866,3898782,6623233,40368243,29597491,53114544,0.952678436555,0.879614321548,1.02274129057
2020-08-12,1505,166012,,,,,,,312639,233086,410588,5070667,3849165,6561678,40680882,29830577,53525132,0.954147170657,0.881689486498,1.02495325616
2020-08-13,1070,167082,,,,,,,309448,229607,407291,5015171,3799116,6501442,40990330,30060184,53932423,0.955630662395,0.88340186885,1.02665329533
2020-08-14,1338,168420,,,,,,,306390,226229,404367,4960510,3749028,6442846,41296720,30286413,54336790,0.957125566922,0.884254793565,1.02823905056
2020-08-15,1034,169454,,,,,,,303442,223150,401913,4906800,3699140,6386516,41600162,30509563,54738703,0.958630973766,0.886429264476,1.03108840402
2020-08-16,571,170025,,,,,,,300587,220016,399734,4854150,3649039,6332439,41900749,30729579,55138437,0.960146100262,0.888537609675,1.03419605819
2020-08-17,446,170471,,,,,,,297825,216948,397530,4802657,3599055,6280674,42198574,30946527,55535967,0.961670670287,0.890805361336,1.03659062141
2020-08-18,1325,171796,,,,,,,295156,213995,395370,4752415,3549370,6231151,42493730,31160522,55931337,0.963204653681,0.892125557164,1.03939810349
2020-08-19,1353,173149,,,,,,,292594,211219,393196,4703510,3500459,6183929,42786324,31371741,56324533,0.964747334464,0.893528016122,1.04230540741
2020-08-20,1079,174228,,,,,,,290136,208467,391035,4656023,3452002,6138478,43076460,31580208,56715568,0.966298291208,0.895916687986,1.04505146176
2020-08-21,1105,175333,,,,,,,287779,205744,389406,4610031,3404213,6095695,43364239,31785952,57104974,0.967857502957,0.898272822433,1.04795806835
2020-08-22,982,176315,,,,,,,285520,203014,387828,4565602,3357204,6054944,43649759,31988966,57492802,0.96942509378,0.900054759461,1.05097003663
2020-08-23,450,176765,,,,,,,283358,200242,386439,4522803,3311003,6016769,43933117,32189208,57879241,0.971001382353,0.900273758709,1.05383822597
2020-08-24,442,177207,,,,,,,281297,197775,385246,4481394,3265593,5981043,44214414,32386983,58264487,0.972586460651,0.900769771174,1.05661003121
2020-08-25,1239,178446,,,,,,,279337,195393,384695,4441439,3221280,5948326,44493751,32582376,58649182,0.974180482235,0.901481891433,1.0597342394
2020-08-26,1225,179671,,,,,,,277479,192990,383838,4402987,3178009,5918240,44771230,32775366,59033020,0.975783838405,0.901800438427,1.06265444969
2020-08-27,1111,180782,,,,,,,275721,190566,383452,4366069,3135494,5891107,45046951,32965932,59416472,0.977397134006,0.901887513021,1.06549275953
2020-08-28,971,181753,,,,,,,274064,188355,383316,4330685,3094246,5867137,45321015,33154287,59799788,0.979021147866,0.901405157671,1.06823944163
2020-08-29,958,182711,,,,,,,272509,185971,383195,4296804,3053993,5845971,45593524,33340258,60182983,0.980656700297,0.900944096752,1.07124441849
2020-08-30,310,183021,,,,,,,271057,183583,383344,4264419,3014428,5827404,45864581,33523841,60566327,0.982304716853,0.901868993263,1.07429489175
2020-08-31,573,183594,,,,,,,269708,181276,383841,4233540,2975690,5811500,46134289,33705117,60950168,0.983966353419,0.901616457495,1.07726443698
2020-09-01,1067,184661,,,,,,,268464,179067,385095,4204180,2937810,5799046,46402753,33884184,61335263,0.98564301948,0.901522901106,1.0802143528
2020-09-02,1056,185717,,,,,,,267325,177054,386520,4176349,2900870,5790169,46670078,34061238,61721783,0.987336344848,0.902152814907,1.08317685787
2020-09-03,1070,186787,,,,,,,266292,174904,387547,4150048,2864556,5784493,46936370,34236142,62109330,0.989048086659,0.902321984179,1.08593307891
2020-09-04,965,187752,,,,,,,265367,172646,389050,4125279,2828737,5782474,47201737,34408788,62498380,0.990780070175,0.902475325416,1.08940617785
2020-09-05,783,188535,,,,,,,264550,170576,390306,4102050,2793571,5783338,47466287,34579364,62888686,0.99253413292,0.902986204321,1.09250087059
2020-09-06,403,188938,,,,,,,263843,168713,391826,4080373,2759272,5787297,47730130,34748077,63280512,0.994311984975,0.902965836267,1.09556866203
2020-09-07,267,189205,,,,,,,263247,166662,393736,4060262,2725694,5794554,47993377,34914739,63674248,0.996114977665,0.903265927134,1.09874794298
2020-09-08,445,189650,,,,,,,262764,164739,396916,4041729,2692661,5806200,48256141,35079478,64071164,0.997943820381,0.903251621798,1.10207297459
2020-09-09,1206,190856,,,,,,,262394,162877,400360,4024785,2660144,5821846,48518535,35242355,64471524,0.999798342969,0.90335700258,1.10601086938
2020-09-10,907,191763,,,,,,,262139,161081,404002,4009446,2628235,5842009,48780674,35403436,64875526,1.00167738213,0.903718606165,1.11047373427
2020-09-11,1213,192976,,,,,,,262002,159269,407823,3995726,2596940,5866387,49042676,35562705,65283349,1.00357881632,0.903989286253,1.11497075982
2020-09-12,714,193690,,,,,,,261983,157681,412269,3983645,2566266,5895361,49304659,35720386,65695618,1.00549973895,0.904138356773,1.11986406656
2020-09-13,378,194068,,,,,,,262085,156230,416265,3973221,2536524,5928466,49566744,35876616,66111883,1.00743672478,0.904634079067,1.12409250276
2020-09-14,422,194490,,,,,,,262310,154640,420710,3964474,2507581,5965859,49829054,36031256,66532593,1.0093861316,0.904921512312,1.12760819332
2020-09-15,1288,195778,,,,,,,262661,153163,425062,3957427,2479468,6007098,50091715,36184419,66957655,1.0113443818,0.904982996248,1.13093569217
2020-09-16,983,196761,,,,,,,263139,151649,430869,3952102,2452049,6052888,50354854,36336068,67388524,1.01330818102,0.905244890357,1.13577875528
2020-09-17,870,197631,,,,,,,263749,150340,437125,3948525,2425332,6103518,50618603,36486408,67825649,1.01527465438,0.90527389099,1.1403370389
2020-09-18,936,198567,,,,,,,264492,149034,442977,3946724,2399461,6158970,50883095,36635442,68268626,1.01724139828,0.905370595554,1.14389622683
2020-09-19,712,199279,,,,,,,265372,147688,448701,3946730,2374502,6218636,51148467,36783130,68717327,1.01920646107,0.905277702314,1.14827053195
2020-09-20,227,199506,,,,,,,266394,146470,455615,3948573,2350399,6283956,51414861,36929600,69172942,1.02116827822,0.9051321439,1.15233623015
2020-09-21,356,199862,,,,,,,267560,145492,462801,3952290,2327179,6354927,51682421,37075092,69635743,1.02312559156,0.905048741527,1.15651546345
2020-09-22,921,200783,,,,,,,268874,144377,470658,3957916,2304896,6431839,51951295,37219469,70106401,1.02507737442,0.904914272399,1.16066850869
2020-09-23,1098,201881,,,,,,,270341,143321,479048,3965494,2283481,6513964,52221636,37362790,70585449,1.02702277125,0.904785083301,1.1647982715
2020-09-24,914,202795,,,,,,,271965,142263,486822,3975065,2262870,6600415,52493601,37505053,71072271,1.02896105027,0.904541443288,1.16890149826
2020-09-25,952,203747,,,,,,,273750,141324,495684,3986676,2243118,6692092,52767351,37646377,71567955,1.03089156548,0.904387122039,1.17297508567
2020-09-26,740,204487,,,,,,,275701,140474,504770,4000376,2224325,6789037,53043052,37786851,72072725,1.03281372608,0.904297154168,1.17701600677
2020-09-27,266,204753,,,,,,,277823,139581,514837,4016216,2206229,6891609,53320875,37926432,72587562,1.03472697279,0.904205875755,1.18092256075
2020-09-28,316,205069,,,,,,,280120,138720,525192,4034250,2188723,7000531,53600995,38065152,73112754,1.03663076047,0.904055061902,1.18484129449
2020-09-29,914,205983,,,,,,,282596,137917,537581,4054536,2172004,7117393,53883591,38203069,73650335,1.03852454567,0.903909956486,1.18871325885
2020-09-30,,,700.769988856,465,1017,206683.769989,206448,207000,285256,137133,549971,4077132,2155977,7242289,54168847,38340202,74200306,1.04040777717,0.903770133457,1.19253479236
2020-10-01,,,699.08832155,460,1022,207382.85831,206908,208022,288106,136383,564241,4102099,2140717,7375654,54456953,38476585,74764547,1.04227988851,0.90368241279,1.19610748971
2020-10-02,,,697.713052689,455,1025,208080.571363,207364,209046,291152,135748,578198,4129502,2126129,7516724,54748105,38612333,75342745,1.04414029161,0.903817621212,1.19959463808
2020-10-03,,,696.64237583,450,1031,208777.213739,207814,210076,294400,135135,591106,4159411,2112234,7664842,55042505,38747468,75933851,1.04598837177,0.903662779253,1.20296503454
2020-10-04,,,695.880386709,445,1037,209473.094126,208260,211113,297856,134642,604853,4191895,2099195,7820977,55340361,38882110,76538704,1.04782348338,0.903149058181,1.20642794393
2020-10-05,,,695.431512445,441,1045,210168.525638,208702,212157,301527,134222,618697,4227028,2086953,7984044,55641888,39016332,77157401,1.04964494641,0.903095061243,1.20976463336
2020-10-06,,,695.302910789,437,1054,210863.828549,209139,213210,305416,133773,634138,4264884,2075236,8155358,55947304,39150105,77791539,1.05145204317,0.902954206912,1.21294913215
2020-10-07,,,695.504067952,432,1066,211559.332617,209571,214276,309532,133339,648930,4305543,2064201,8333602,56256836,39283444,78440469,1.05324401516,0.902811450898,1.21558298339
2020-10-08,,,696.039115599,428,1078,212255.371732,210000,215353,313881,133167,665068,4349083,2054053,8519592,56570717,39416611,79105537,1.05502006005,0.902666836068,1.21808818775
2020-10-09,,,696.913281,424,1092,212952.285013,210425,216445,318467,133034,684017,4395584,2044829,8716756,56889184,39549645,79789554,1.05677433435,0.902456260455,1.22057866604
2020-10-10,,,698.132534276,420,1105,213650.417548,210846,217549,323296,133006,702410,4445130,2036519,8923448,57212480,39682651,80491964,1.05850206708,0.902562634514,1.22286844964
2020-10-11,,,699.703557296,417,1119,214350.121105,211264,218667,328373,132884,721334,4497801,2028935,9139971,57540853,39815535,81213298,1.06021056832,0.902666901291,1.22583267903
2020-10-12,,,701.633727151,413,1132,215051.754832,211677,219799,333704,132780,740894,4553681,2022139,9365986,57874557,39948315,81954192,1.06188286783,0.902769108501,1.22837852265
2020-10-13,,,703.931129719,410,1150,215755.685962,212088,220948,339293,132837,762543,4612855,2016266,9603305,58213850,40081152,82716735,1.06352077453,0.902869303979,1.23014850961
2020-10-14,,,706.013208629,407,1167,216461.69917,212496,222114,345144,132749,784261,4675403,2011109,9849958,58558994,40213901,83500996,1.06510711519,0.901361835248,1.23330929901
2020-10-15,,,708.483523328,404,1184,217170.182694,212900,223298,351260,132614,807669,4741406,2006599,10107626,58910254,40346515,84308665,1.06663628673,0.901205084976,1.23525338303
2020-10-16,,,711.350922064,400,1201,217881.533616,213301,224498,357647,132597,830869,4810948,2002821,10374214,59267901,40479112,85139534,1.06812574639,0.901046207859,1.23767854301
2020-10-17,,,714.624894381,397,1219,218596.15851,213698,225717,364305,132743,855924,4884101,1999824,10651906,59632206,40611855,85995458,1.06955015621,0.900885258229,1.23859658715
2020-10-18,,,718.315461152,394,1239,219314.473971,214093,226955,371240,133052,882873,4960941,1997747,10943622,60003446,40744907,86878331,1.07092129985,0.900722289981,1.23630619432
2020-10-19,,,722.433222457,391,1260,220036.907194,214485,228215,378448,133488,909718,5041532,1996598,11248413,60381894,40878395,87788049,1.07223428853,0.900557357303,1.234688453
2020-10-20,,,726.989370571,389,1284,220763.896564,214874,229498,385933,133898,936148,5125939,1996283,11565780,60767827,41012293,88724197,1.07345025521,0.900390462981,1.23447872432
2020-10-21,,,731.995712011,386,1308,221495.892276,215261,230805,393697,134320,966143,5214219,1996837,11897698,61161524,41146613,89690340,1.07459409368,0.900221812168,1.23359205004
2020-10-22,,,737.464657975,384,1330,222233.356934,215646,232134,401737,134930,996948,5306424,1998434,12245608,61563261,41281543,90687288,1.07566066282,0.900051125369,1.23270523555
2020-10-23,,,743.409202031,382,1357,222976.766136,216029,233490,410053,135499,1026580,5402596,2000773,12607002,61973314,41417042,91713868,1.07665505439,0.899878873546,1.23254968217
2020-10-24,,,749.833486909,381,1385,223726.599623,216411,234874,418641,135997,1057945,5502771,2003740,12980819,62391955,41553039,92771813,1.07756468587,0.899704940617,1.23224618219
2020-10-25,,,756.752207101,379,1415,224483.35183,216790,236288,427498,136799,1088832,5606973,2007537,13367119,62819453,41689838,93860645,1.0784026107,0.89952938736,1.22886454572
2020-10-26,,,764.180584412,377,1448,225247.532415,217168,237736,436615,137492,1120592,5715216,2012151,13766257,63256068,41827330,94981237,1.07917527739,0.899352278009,1.22850939745
2020-10-27,,,772.13432996,376,1484,226019.666745,217544,239219,445989,138414,1153706,5827501,2017791,14178948,63702057,41965744,96134943,1.07989755577,0.899173681321,1.22772123644
2020-10-28,,,780.629552798,374,1524,226800.296298,217919,240742,455616,139207,1187023,5943824,2024170,14603279,64157673,42104951,97321966,1.08056335072,0.898993672285,1.22486436568
2020-10-29,,,789.682781229,372,1565,227589.979079,218293,242306,465484,140220,1221095,6064164,2031653,15039981,64623157,42245171,98543061,1.08116481347,0.898812334315,1.22468311945
2020-10-30,,,799.310905865,371,1601,228389.289985,218664,243906,475586,141147,1254227,6188490,2040199,15486416,65098743,42386318,99797288,1.08169485185,0.898629214226,1.22377203477
2020-10-31,,,809.531121006,369,1639,229198.821106,219035,245544,485910,142178,1288003,6316752,2049785,15943430,65584653,42528496,101085291,1.08213661921,0.898445491365,1.22227569075
2020-11-01,,,820.360908976,368,1679,230019.182015,219404,247222,496448,143102,1319567,6448895,2060151,16406957,66081101,42671598,102404858,1.08251242744,0.89826077383,1.22184728336
